HHBNHNHHNNBHBHNNHHNHBNNHHHNNHHHBNBBNHNHBNHHHNNNNNHNNNNNNBNNBHNNNNBHNBNHNNNHNHNNNBNHNNHNBNHNNHBNNNNNN
BBHNHNHHNHNHHNNBHHBNHBHNHBNNBNHBNBNBHNHNHHBNHNNBNHNNHHHHNNHBHBBHBHNBHBNHNNHBHNBNHHBBNBNNNBNBNHNHNNBH
NHBNNHNHNNNHHBNHBNBBBNNNNBNNNNBBHBNNNNNNNHNNNNHNNHHHHHNBHNHNNBBNHNNHBHNNNNNHNNNHBBNHNNBNNNBBHNBHNNNH
NHNNHNNHHHBHNHHNNHNHBHHHBBHNNHBHNNNHNNBNNNHNBHNHNNHHHNHHNHNNHNNHBHNHNBNNBBHNBHBHHNNNNNHHNNBNNNHBNNNN
NNNNNNNBHNNHHHHNNHNBNNNNHNHBNNHNNHNHNHNBNNNHNHBNHBHNNHHHBNHHHBNHHNNNNNNHBBHNNHBNNNBHBNHHHBBNBNNNNBBN
HBNHNHNHNHHBNHBNNHNBNNNBNNBHNHNNHNBNBNHHHBNNNNBHNNHNNHBNHBHNNNBNHHBNNNNHNHHNNNHHBBBHNNNNHHHNHBNHHNHH
NNHHNNBHHBNBHNNHNNBNHBHNNBNHBNHNNBHBNBHBNHHNHNNHNNNHBNNNNHNNHBNHBHBNNNNHHNHHNHHHNNNHNHNNHNBHBNBHNHHN
BNNNNNNNHBHHBBNBBNHBHHNNNBHHNNHHBNBNHNNNHNNNNNBNNHNBNNHBHNNHHNNNHBHHNHNBHHHNNHHNNNHBBHBBNHNNNHNHHHHH
NNNBNNNNHNNHNBHBNNHNNNHBHBNNBNBHNBNNHNHNHHNHHBNBNNNHNHHBNNNNNBNNNNNHNHNHNNNNBHHNNNHBHNNBHNHBNHHHHHNN
NBNNBHBHBNNHNNNNHHNHHHNHHNHNNNHNHNNHHBNNNBBBNHBBNHNHBHHHHNNNNNHNNNBNNNHHHBNHBNHNBHHBNNNNBHBNNBNHNNNN
BNHNBHBHNHNNNNNNHNHHNNHNHNHHHHHNNNNBHNBHHNNHHNNNNBHNHHHNNHBNBHNHNNHNBHNBBHNNBNNNNBBHBNNNNNHNHBHHNHHH
NNBNNHHNNHHNHHNHNHNHHBNNBHNNNNHBBNNNNHHNBNNBHHBNHNBNHHBNHNNHBNHHNHNBBHHNNNBHBBHBNNNHNBHNNNHNHBNHNNHN
HNHNNNNNBNHHBBBNHNHHNNNHNBBBHNHHHBBBNNNNNHHNNNNBBNBNHBBBBHBHHNHNHHNNNHNNNHBBNNNHNNNNBNBBNBHNBNHNBNNB
BBBNHNBNBHBNHHBNBHNHBHNBNNBHNNBHNNHNNBBBHNNBNNBNBBNNNHNBBNBNBNNNHBBHNBHNNNNBHNNNBNHBNNHNNHBNHHHBHNNN
HNHHBNNHNNBNNBNHHBNBBNBHNBHNBNNNNNBHNNNHHNBNNNNNNBNNBHNNNBNBNNBBNHHHNBNNNNNBNNNBNNHBBNHNNNBNNNHBHHHN
HNNNHBBNBBHBBNNNNHNNBNHBNHBNBHNHBBHNNNNNNNHNNNNHHNNNNBNHNNNNNNBNNNBBNBNHHNNNNHHHNNBNNBBBNHNBHNNNBNNB
HNNNHBNNNNNNBHNNNBNNNBBHNNNNNBNNNNNHNNHNBBBNNNNNNNNNBHNNHNNHNNHHNNHHNBNNBHNNNBNBBNNBHNNNBBBNBHNBBNHN
HHNHNHHHHBBHNHNBNNHNHNHBNBHHNHHNBNNNNNHHNHHHHHNNNBHHNNNBBNHNNNBBHNBNNHNHNNNHNBNNHHNHBBNHNNNHNBBNNBNN
NNNHHHNBNHNNHHNNNHHNNHNHHNHBHNHBHNNNNNNBNNNHHHHHHNBNNBBBNHBHHNHNNHBHNNBHNNNHNNNHNHNBBHNBHHNBBNNHNNBH
NBHHNNNBHNHHNHHHNNNHBNNHHHNHBNNBNNNHNNNNNHHNBNNHBHNBBNBNNHHBBNHNHNNNBHNHNBBHNNNHBNHNBHNHNNHNHNNBHNBB
NBHBHNNHBNBNNBNBNNHNHHHHNNBHBNNHHHNBBNNNNBHNNNNNHBNNNHNHNNHBNNHNNHHHNNNBNBNHBBHNHBNHBHNHNNNNNHHHBBNH
NNHNNNNNHHBNNHNBNHNBNNHHBNHNNNNNNNBBBNNNHNBNBBNNNBNBNHHHNNHNHNBNNBBBNHHBHHNBBBNBNBHHNNHBHBNBHBNHBHBB
HNHNNNHNBBHHNNHNHHBNHNBNHBNNNNNNHHBNNHNHHHNHNNNNBBNNNNHHNNHNBHBNNNHNHHNNBNHNNBNNHNNHNNNNNNBNHBBNHNBN
BNNHNHHNNHNNNHHNNBBBNHNHBBNNNHNHNHHNBHHBNNNNHNNBHNBNBNNHNNHNNHNNBHHNNNHBNHHBNNNNNNNHHHNNNNNHBNBBHHHH
BBHNNHHBNBBNHNNNHHNBNNNHBNHNNNNBHNBNBNHNHHNNBNHNNNBHNHHBNNHBNHNNHNNNHHNNHHNNNBBHNBNHBNHNNNNHHBBHHHHN
NHHNNNNNNNNBNBHBNBNBNBNHNHNHNHBNBNBNNHNBNHNHBNBNBNHHNBNHHNNNBHNNNBBNNBNNNHHHHBNHNNNBNNNBBHNNNNNHNHNN
NHNBHHBNNBNNNNNHBBNNHHHBBBNHHNHBBNNNNNHBBNNHHHBBNHNNHBBBNNHHBHNHHBBHNBHHHHHBNNNNHHHHNNNHHHBHHNNBBNHN
HNBBNHHBHBBBNNHHNHNNBHNHHNNNNBNNHNBHNBBNNNNNHBHBNHBBNNNHBNNHNHHBNNNNNHBHHNHNNNNNNNHHHNNNNHNHNBBNNNNN
HNBNNNNNHHBHHBNNNNHNBBNHNNBHNHHNBNHBNNNNNNBHBBNHNHNBNHHBNBNNNHHNBNNNNNNHNNNHHHNHHHNBNNBHNBNNHNHHNBHN
BHNHNNNHBNBHNBHHNNNHNNHNHNBHHNBBHNHNBNNHHHNNNHNHBNHNHHNNHHBBNBHHNNHNHNBHBHHHNHNNNNNHBNHHNHNNNNHNNHNN
BNNHNNNNHNHNNHBNBHNNNHBHNNHNNNNNHNBNBBNNBBNHNBNNNNNBBHBHNBNNNHNNNNNHNHHBBHNHHHNHNNNNBNHHBBNHNNNHBHNN
NNNBBHBNNHBHNHHNBHNBNNBBNNBHHNNHNNHHNBBHNNNBBHNBNNHBHNNNBNBHHNBHBNNBNNNHHNBHNBNNNHHNBBHNNBHHHBHNNNHB
NBNHHHNNHHNNBNNBHHNHNHHNNHNBHHNNNNNNNBNHNHHBHNNBHBHNNBNNNNNBHNNBHNHHNHNNHNHHNNBNNHBBNNNBBNNBNNBNBNBN
BNNNBHNNHHHNHNNHNNHBNHNHNNNBNNHNNNBNHNHNNHBHNHNNHHNNNNNBNNNNNBNBHNNBHBHBNNBBHNNBNNNNBNNBBNHHNNNHBHNH
NNNHNNNNNNNNBNBNNHHBHNHBBHHNNHHHNBNBNHHNNNBNHBNNBNNNNHNNBBNNNHNHNNHNNNNHHHBBNHNBBBNHBNNNHNNBHNHNNNHB
HHBBNNNHNNNBNNNHHHNHNHHNHBNBHNHHNNHHNNNHHBBHHBNHHBNNNNNNNHHBBHHNHNNBNBHHHNHBNNNHBNNBNNHHHNHBHHHBNNBB
HNNHNNNBNNNNNHNBHNNNNBHHBNNNHHNHNNNNBNBNHBHNBNNHNNBHHNBNNHHNNNNHHNNNNNNNBNBNHHNBNBNBNNNHNNNNNNNBNNNB
NNBBNNNBHHNNNNBHHNNNHNBNHNNNHBHBBHNNBNHNNNNNHNHHNNNHHBHNNNNHNNHBBNBHBNBNHHHBNNBHNNNBBNBHNBNHNHNNHNNB
NNHBNNNHNHHNHNBNHHNBNNHNBNBHHBHHNBNNNNNNHNHBNHNBNHHHNNHHNHNNHHNHNHNNNNNBNNNNNNNHNNNNNBNHBNNHNHBNNHNN
NNNNBBNNHNNHBNBNNBNHBNHNBHHNBBHHHNHBNHBNBNNBNHHBHHNHNHBNNHNNNNNNNNHHBHHNNBNHNNHNHBHNNNHHNHNBHHHNNNNB
NNNNNHHNBNHNBNNNNHNHBBBNNHHHHNHNNNHHHNNHBNBHNNHNHHNNHHNNHNNHNNHNBNHHHBBNNHHNHHHBNNNNNBBNHNNHHNNNNBNN
NNHNHNBHNHNNNNHNNHNNHBHHNBNNNBBBBNBNHNNBHHNNBNNNNNBNNNNNHNHHNBHNNNNHNNBHHNBBHNHHNBBNBNBHBNNHBNNNHNNN
BBNBNNNNNNBHNNNNHNNHHNNBNNHNHHBHBNNHNNNBNNBHBNNBBHBHNHBBNNHNHHNHNBNNNHNHNNNNNBNNHNNHNNHNNNNHBNNHHBBN
NBNBBHNNNHBNHNNNNHHBHNNHNHNHNNHNBNNHHNNNNBHHNNHNBHNNHBHHNBHNNBNHHNNNHHNNNNNHNBNNNNBNNNNBHNNNNBHNNBBH
NNNBNNNNHBHNBNNNNBBNNNBHBNNNNBBNHNBBNNNNNNNHNBBNHNNNNBNNHNHHNNNNNNNHHNBHHNNBHNHHNNNNNHHNNHNHNBNNNNHB
NNHNHBHHNNNNHNHHHNHBNNNNBBNHNBHNNBNHNNNNNNHHNBBHNHNBHHHHNBBNBNNNHNHHNNHNHHNHHHNBNNHNBHHNNNNNBNNNNNNH
BHBHHHHNHHHHNNNNHBHNHHNHHNHNHHNNHBNNHHHHNNNNNHHHNNBHBNNHHNNNHBNBBHBHNBBHHHNNBNNBNNBNNHHNHHHNNNNNHBNH
BNHNNNBNBNBNBHHNNHHBNBBNHHHBBHHNBNNNHNHBNHBNHHNNNNNHNBBNNHBNHNNNBNBHNNNNNHNBNNHHBNNNNNNBNHNNBNHNHNNN
HNHNBNNBBNHBNBNNHHNHBNNNNHHHBNBHNNNNNNNNNNBBHNNBNBNNHNHNBNNNNNHHHHBNNNHNNHNNHHNNNHBNNHNNBNBBNNHHNHHH
BNHHHNHNNHHBNHNBNNNHNHBNHNNBHNHNNNNBBHNNNHHNNNNHNHHBBBNNNNHNNNNHNNHNBHBNNNNHHBHHHBNBNHNNHNNHBBNBNNNH
