BBBHHBNHHNBHBHHNBNBHBBNHNNNNBHNNHNBNBBNBNBHNNNNBNNNNNNHBNNNNNNHBHNNNHNNNNHHHNNBNBBNNNNNNNNNHBNHHBNHN
BHBHBHBHNHBBBBNNBBNHNHBNNNNNNNNBBHNBNNNNNNBNHHBNHNBBBNNHNNBNBNHHNNHHBBHHNHNBHNNNBNHHHHNHNNBNNNHNNBNB
NBHHBNNBNBNHHNNNNNHHHBHNHNBNHHHHNBNNBNHNNNNNHHHNNNNNHBBHBHNBNNHNHHBHBHNNHHNNHNNNBHBNNNHBNNNNHBNNNNBN
NHHNNNHHHHNHHBHHNHNNHNNHNNNHHBBBNNNNNHBHNNBNNHNHHNHNNNNNNBNBNHBBNNHBNHHBHHNHNNBBBNBNBNBNHNHNNHNNNNBH
NNHBBNHNNHNHNBNHNBHNNNNNNHHHNHHNHBHBBNHNBNHNBBNNBHHNBNHNHNBNHBHHNNNNNNNNNNNHHBNHNNNNBNBHNNNHBHNHBNNB
BNBNNNHHHHHNNNNNHBHHBNNNBHHBNHNBHNHHHNNNNNNBHBHNNBNHNNHNNNNBNBHNNNNNNNNHNHHHNHHBBHNHHHNNHHNBNBNNHNBB
BHHNNBHNNHHHHNBBNHNBHNHNHHHHHNNBHHHNNNBHNBNBBHNBNBNNHHNHHNBHHHNNNNNNHNNNHNNNNBNBHHHHHNBHNHNNBNBHNNHN
NHNNNNNHNBNNHNNNNHBBHNHNHBNHHNNHHHBNHNNNNHHNBHHNNNNNHHHNHNHNHBBHNBBHNHNNBNNBNHNNNNNHNNNHNNNNHHNNHNNN
NNNHHBNBHNHNNBHNBHNBNBBNBBNHNNNHNNBNNNHNHBBBNNNNNHHNNBNHNHBNNNNBNNBNHBHBNBNNHHNHBHHHBHNNNNHNHHNHBHBB
NNNBNHNNBNHNBBHNHNBNNNBHNNBHHNHHNHHNNNNNNHNBHBNHNNNNNNNBHHNNNBNHNNBBNBNNHHNNNHNNHHHNNNNNNNNBBNBBNHBN
NNNHNBHNHNHBHNNNNNNBNNHBNNHHNNNNNBNNNHHNHBNNNNNNNHHNBBNHHHNBNNHBNNHBHHBNNNHHNBHNNNBHNNHNHHHNBBBHHHNN
BHNBHBNHNHNNNNHNNNHBNNNNHNBBNHHNNNHNNHBNHBNHHHBHBBBNNBHNBNBNHNHNNNBNHNNHBBHBBHNNNHNHBHNHHNHNHNHNNNHH
BNHNNHNNNBNNNNHNHHNNBHBNHNNNHBHNNNNNHNHBNNNNHNNNNNNNNNNNBNBBNHNNNNNBHHNBHBNNNNNBBNNHHNNNNBBNHNNNNBBN
NNNBNBNBNNNHHNNNHNNHNHNHBNNBNNHNNNNHNHNNHBHHBNNHNNNBHBHBHHNNHNBNNBNHNBNNHHNHNNNHNNNNBBBBHNBNBHHNHNHN
BNHNNNNBHNNNHHBHBHBHBNNNNNHHNBNHNNHNBHBHNNNNNHBBHNNNNBBNHHBBHHNNNBHNHHNHBBNHNHNNBNNBBBHHNNNNNBBHNNHH
BHNNNHHHNNBHNNHHBNNBHNNHNHHNNNNNNBNNNNNNHHBHNNNHNBBBNNNNNHBNNNNHHNBNNBNBBNHBBHNHNNBNNHNNHNHBNNNBHNNN
NNBNHHBBNHNHBHBNHHNHBHBNBNNNNNNHHHHNHBBHNHNHHNNHNHNBBNNHNHNNBBHNNNNNHNNNNBNNBNBNBBHNHNNBNNNNNNHNNNHN
HHNBNNNNNNNHNBBHHNNHHNNNBHHNNBNBNHHNHHBNHNNNNHNHNHNBNHNHBHNNBNNBHNNBBNBNHHNNBNBNBBNHHBHNHHNNHNHHHNHN
HNBHNNHNHNHNNHHHBNNHNHHBNNNNHNNNBNHNBHNHHNBNHHBNNNNNNNBBHHHNNHBBNBBNNHNBBHNBHBNNNNNNNBHHNHNNNBNNHNHN
NBBBNNHBNNHHNNNHHNHNHHHHNNBHHNBNNNNBNNHNNNNBNHNHNNBNNHHNNNNBNHNHBNHHBHBNHNHNHBBNHBHHHHHBHNBNHNNNNBHN
NBBHNHNNNNNHHNBNNNNBHHNNNBHNNBHBHNNBHNNNHNBBHNBHNNBNNNNNNHNNNHNNNNHBBNNNNNBHHNBBHHNBNNNHNBHHHHBNBBNB
NNBNBNNHBNHHNBBBNNNBNHNHNHNHNHNHNNHBHNNHNNHNHNNHBNHHNHHBHNNHHNHNHBBHHNHNNHHHNNBNHBHNNNNHHHHNNBHHNNHN
NNHBHNNBNHHNNNHHBHHNNNHHNHNHNHNNNNHNBNBNBBHBBNHHHNHNHBHNBNNHNBHNHNHHNNBNNNNNNHNNBNNNHHHBBNHHNHBHHHHB
NHNBHNNHHNNNHHHHHBNHNBHNHNHHNHBNHHHHNBNHHHHNHNNBHBHNHHNHHNHNBBNNHHNBNNHHHHBHHHNNNNNNNNHHNHNBNNHNHNHH
HBHNNNHHHHBNHBBHNBNNNNHBHHNNHBNHHNNBHHNNBNHBHNBBBNNHHBHBNNNNNBHBHNBNNHNHNNHBNHBNNNHNBNNHNHBHNBHNNHHH
HNNHNBHBNHHBBHHHNBNNBHNNNHHHBNNBNHNHBHNBHHHBBHHBNNBBNBHNNNHNNHHBNNNHNNNHNBHHBNNNNNBHHNNBNHHBBBNHNNNH
NNNBNNNNHNHNNHHBBBHNHNBBNNBNNNNHNNBNNNHNHBHBHNHNBHHNNHBBNNHHHBHHBNNNNNHNNNHHNHNBNHBHHNBHNNNNNBNNHHBN
NHNNNNBNHHHHNHHNNHHBBNBNBBBNHNHHHBNNNNNNHHNHNNBNNNNNNNHNHNBNNHNNBBBHHNHNNHNNNNNBNHHNNHBHHNHHNNNNHNNN
NHBHNHHNNBHNHHNHNHNNHNNHNHBNNHNNHNNNHNHHBNNNBBHBBHBBHHHHNHHHNHNNNBBHNHHNHNBBNNHNHHNBNHNNNNHHBHBHHNNN
NNBBBHNNHHHNHNNNHNHNNNBHNHNNNNHNHNHHNNHHBBHNNHHNHNHNNHNNNNHBBBNNNHBHHNNNHNHHNNNNNNBNNNNNBNHNBHHNHNHN
HHNNHNNHNNHNHBBNNNNNHNHHBHHNNHBHHNNBHNHNBHNHNHNBNNNNHBNNBNNNHHNNBHNNNNHBNHBHNNNHNBHNHHHNBHNNHNHHBNNH
HNNBBHNNNNHBBHBNNBNNBBNNNBHNNNBBHHNBNHBHNNBNHNHNNNHNNBNBHBHNHBNHNNHNHNNNBNNBNHBNNNHBNNHHHHNNNHHNNBNN
HHNHHHNBNBNBNNNBBNNHBNHBNNHBHNHBBNNNBNHHHNHHHBNHHBNHBBNNNNNNNBNNHNHBHBNHHHHHHNBNNNBBHBNNNHNHNHNNHNHN
NNNNHHNNBNNNNNHHHHBHHBHHNHHBNHBNHNNNHNNNNNNNHBNNBHNNNHHHBNHBNNNNBNHNHBNNNNHBNBHNHNBNHHHHNNBHNBNBNNNN
BBHNNHNNBNNNNNNBNBBBNBNNNNBNBNNHNNNNHNHNHNNBNHHBBBHNNNNNHBBHNBHHNNHNHHBHNBHNBNNNNHNNNNHNHNNNBNHHNHNN
NBNHNBBHNNNHNHBBNBBNNNHHHHNNNNNHNHNNNNBNNNNBHNBBHHNBNNNNBBNNNHHNNHHBBNNBBNHHHHBHNHHNNNBHNHBNBNNNNNNN
NBNBBNNNHHNNHNHNBBHNHNNNNNHHHNHNHNNNNNBHHHHBNHHBBHHHNNNNNNBNHHNNNNNBHHNHHNNHHHNBHHHBHHNBHNHNNHHNNHNH
NNHBBNHNHBNNNNNHHBHNHHNNNHNNNNNBBBNNBNHHHNNNHNNNHNNNNBNHNNNNBBNNNBHHBNNNHNNBNNNNNNNHBNNHNNNHHNNNBHNH
BNNHHHNBBNNNHNNHNHHNNNNHHNNHHBHBHHNBNBNNHNBBNBHBBNNHHNHBNHNNNNBHBBHNBHNBNNBBHHHBHNHNHHNBHNBBBNHNNHBH
NNNBHNHNNBNBNHNHNNNNNNBBNNNBNNBNBNNBHBNHNNNBBNBNNNNNNNBBNHNHBHHNNBNBNHHHNHNNHHBNNBNBBNBHNNHNNHNNHNHN
BHHBNBNBNBNBHHNNHNNNBNNNNNHBHNHHNNNNNBHNNBBNHNHNHNNNNNNNNNHBNNNNNNNHNNHNBNHNHNBNNBNBHBNHNNNBHHHNNBNB
NNHHHBHNBNNBHBHHHNHHHHNBNBNNBBNBNNNHHNHNHBNBNNNBNHBBNBNBHNHNNNHNBBHNBHNBNHNNNHHHHBNNNNHBBNBNNBNNNBHB
NNHBBBNHNBNBNNHHNNBHBBBNBNNNHNHNHNHHBNNNHBBNNBHNNNBNNHHNNNNNHHBNNNNNHNNNNBNNNNNNHBNNNHNBBNHNNNNNNBBH
NHNHBNBHHNNBBBHHHNHBBNHNHNNNNBHBHNNBHNBNNHBNHHNNNHNNBNBNNBNBBNNNBHNNNBBBNNBHBBHNBNNNNHBNBBNHBNBNNNNN
NNNBHBNHHHHNNHHHNBBHNHBNBHNNNNNBHNNNBBNNNNHNHNBNNBHHNHNHNBNNNBNBNBHHBHNHNNHNBNBNNNNNBHBBNHNBNBNHBNNN
NHBBHHHNBHNHNHNHHNNHNHHNNBNHNNBNNNNNHNBNNHHNNNNHHHNNHHNNHNBHHHNHBHBHNNNNHNHNNNBBBNHNNNBHBBNNHNNHBHNN
HHBNBHHNNNNHNNNBHHBNNBNNHNNNNNBHBNBNNNNNNHNHNHNBNHNNNHHNHNNBHNHNBHHNNBHBBHHNHBNNNHHHNBNNBHHNBHNNNHNN
NNBHNNHHNHBNNBNHNNNBNBNNNBNHHHHBNNBHBNNHBNBNNBNBBNHBNNHHBNHNNNNHNNNBNNNHHBHHNBHHNNBNNNNHNHHBNHNBNNHB
NNNNHHNNBNNNHNNNHBNNHHHNHHHHNNNBNHBNBNNNNHNNBNBHNNBBNBBHBHNNNBNNNHNBNBHBBHHHNHNHNBNNNHNNBNBNBHBHHNBH
NNHHBHBNNNNBNHBNBHNNNHNHBHHHNNNHHHNHHHNNBBHHHHNBNNNNBNNBBHBNHHNHBBNHNNNHHHNBNHNNNNNHBHNNNHNNNHHNNBNH
