NBBHHNHHBNNNNNHNBBHBBBNHHHBBNNHHNNBBBHNBHNBNNNHBBHNNNNNNNNBBHNBBNNNNHHNNHNNHNNHHHNNBNNNNBNNHHNNNBNHN
HNHNNNNNHBBHHNNNNBHNNBNBBNBNNNHHHNHNNNBHBNHBNNNBBNHNHHNNNNNNNBNNHNHHNHBNNNHNBNNBBNBNBHBHNNBHHBBNHHNB
NBNNBNHNNHNNNHNHNNBNBNHBNHNBBNNHBNNHNNNNBNBNNHNNBNNHBHNHHNHHBNNNHBHNNNHBBBNBNHNHNNBHNHNNNHBHNHNNNNBN
BBHHNHNNNHNBNNNNNNNNNBHBHNNHBNBNHNHNBHHNNNNNNHHNHNBHHHNBNNNNNHHNBBBNNBHNHNNNHBBNNHNNNHHHBNHHNNNBNHBH
HHHNNNHHHBNBHBBNNHBBNNNNHHNNNNBNNBNNNNHHHNNNNNNHNBHHBNNHNNNHNBNBNNHHHHNNNNHNNBHHNBNNHHBNHNNNBHNNBNHH
NHHNNBHNNHNBBHHNNNBNHNNNBNBNNBNHNBNHNNNHHHNHNNNNNBNNBNHHNHNNNHBHNBNNNBNNNHNBNBBNHHBBHHNBNBBHBHHNNBNH
NNHBHHHNBHBHNBBHHBBBNHNBBNBHBBNNHNBHBBHHNNHNNNNBNBNNNBBHNNHNHHHBBBHHNNNNBNBHNHNBNNNHNBHBNNBNNHNBNNNN
BNBHHHNHBNNNNNNHHBNHNNNHBNNNNNBNBNBNBNNHNBNBNHBBHBNBNHHHBBHBHNHHNBHHNHNNNNNHNNNNNBHNHNHHNBHBHHHHNHNB
HBHHBNNBBNHBNNHBBNBHNBHNNNNHNNBHHHHHNNHNBHHHBBNHHNHNNHBNNNNNHNNHBHNNHHNNNHHNNNHNHHBNBBNNBNBNNNNNNNHN
HHNBBNBNBBHNNBNNNHNBNNHNNNHNNBHNNBNNNBNHNBHNHHNBHNNBNNBNHNNHNHHNHBHNHNNHNNNHHBHNNNNNHHHBHNHNNBNHHBNN
NNBHNBBHBNNNBBNNNNNHNHNBHBNNNNNHHHBHNHBHHHHNNHBNHBBNNNHNNNHNHNNHNNHNBBNNNNNBNNHHNNBHHBNNBBHNHBNNBNNH
BNNNNBNNNHNNNBHHNNNBNNHNNNNNNHNBHNNHBBHNHNNNHBHHHHNHNNHNNHNNNNNHBBNNHBBNHBBNNHBHNBHNNBNBHNNNNNBNHNHH
NBBBNNHBNHHHHHNBBHNNHHNHNBBBBHNHNNNHHBHHNHBHHHHNHBNHHNHBHHHHHHNHNNNHNBNNNNNNNNNBBNHHNNNBNNNNBHBNBHNH
NBHBNBBNNHHNNNNNHNNNHBNNNNNBNNNNNHNHHHNBBNHNBHNBNNNNNHNHHHHHBNHHBNNBNBBHNBNHBNHNNHBBHHHNNNHHBHNHNNHB
NBNHBNNNHBHHNHHNNNHHBNBNBHNNBHBHHNNNHNHBHBNHHNBHNNNNNHBNHBNBHBBNNNNNHNNNNHNNNNNNBNNNNHNHHBNHBHBHNHHN
NNNNNNHNBBNBNHHNHHHBHBNNBHNBNHNHNBBNNNNHNBNHHHBNNHHNNBNHNNNNHBHNBHNNHHHNNNBNNNBHNBHNNHNHNNBNBNNBBBNN
HNNHBNNHNNBNHNBBNNNNNBHBNHNHHHBHNNNHHHHNHNNNHNNHNNNHHNNHNNHNNHBNNNNNNNNNNHNNNNBBHBNNNHBHNBBBBNNNBHHH
NNHBHNHNHHNNNNNNNHNNBHHHNBNNNBNHNNNHHNBHHNBNNNNNNBHNHNHHNNNHBBNHNNNHNHBNNBNNBHBNNNNHNNNNHHHNHHNBNHNH
HNNHNNNHHNNNHHNNHNNNNNNBNHBBBNNBBBHBBNNNNNNNNNNHBNNNHNNHHNHBNHNNNNNNBHHBNHHHNBNNNHNHHNHBBBHNNBNNNBNB
BHBNBBHHHBNNHHNHNNNBHHHBHNNNBBBNNNNHHNHBHBNBBNHNNNHHHBBNNHNNBHBBNBNNHNBNNHNHBNNHBNNNHBNHNNNNNBNNHNNN
HNHNHNNHNHHNBNNNNNBNNBNNNNHNHHNHNBNNHBBHNHBHNNHHHHHHHHHNNNNHNHNNNBNNNBHHNHBNHNHBBHHNBNHBNHHHBNHHBNNN
HNNHNNHNHNHHHNNHNNNBNNHHHHNNNBNBBNHHHNNHNHHHNHHNNHNBNHNBNHBHNNBNNNHNNBNNHNBHHNHBNBBHNHNBNNNHHNNNHNNN
HNNBHNNBNNHNBNHNNNBHHNBNHHBNBNBHNNNNHNNNNBHNBHNNHNNHNNHNNNNNNHNHHHHNNBNBNNNHNNNHNBHNNNNBHNHHHBHNNNHN
NHHBNBNBNBHNNBNHNNNHNHBNBHNNBNNNHNNNBBHBHNNNNHHNNBHNHNBBNHNNBHNBHHNNNNHBNBBBNHHNNNNNNBHNBNBHBNHNHHBH
NNNNHNBHNNNNBNBNHHNBNBHHHNBNHHHNNBNBNHNNBBBNNNBNHHBHNHHNNHHBHHNNNHHNHNNBNBNNBBBNNHNHNNHNNHBHNHHNNHNN
NHNNNNBBBHNHHHBNHBHNNHNNBNNHBHNNNNBNHHNHNNNHNNNNBNHHNHNNBBNHNHNNBNHNHNNHBHHNNNNNNNBNHNBHNNNHBHHBBNNB
BNNBHNHHBBNNBHHNBNBNHNBBHBNHNBBNNHHNHNNHNHNNNHHNNBNHNHHNNNBNBNHNNHBHHNHHHBNBBNNNBNNNBNNHHNNHNNHHHBNN
NNNBNHNNNNNNNHNNBNHBHNNHHBHHHNBBHNNBNHNHHNNHBNNBNHNBNNBHHHNNHHHNNNHNBNNHHNNHHBNNNNNBNNNNNNNBHNHNBHNN
NNHNNHNNNHBNBHNNNBBNHHBBNBNHNNHNBHNNBHBHBNHHNBHBNHNNBBBNNHHHHHHNBNBNHHHNHNHBHNHHNHBNBNNHBNNNHHBNNNHH
HHNNHNBHNHHBNHNNHHNNHNNNNBHHBBBHHNNBHHHNNHBNNHBNHNNHNHNNHNNHNNNNNNBNBNNNNNHHNHBNNNBHBBNNHHNNHBNNNNHN
NBNNHNBBNNHNNNHHBBBNHHBHNNNNHHNHNBNNHNBHNNNNHBNNNHNNNBHBBNBNNNNHBNHNNBBNHHNNNHHHNBBNHNNHBBHBNNNHNNNH
HNNNNNNNNNHHHHNNHHHHBNBBNHHBNNHNHBBHNNNHNHHNHHBNHHNNNHNNHNNNHNNHNBNNHHHNHNNHHBNBHBBNNNNNNNNNNHNBNHHN
NNHHNNNHBNNNHHHNHNNNHNNNNNBHNNNNHHNNNNNNHNNNBBNNNNBHNNNNHNBBBNHHBNHNHNNBNHNNNBNBNNNNHBHBHNHHBNNNNBNB
BHNHNBNHNHHNHBHNBBHBHBBBNHNNNHNNNHNNNBHHHHNNHNNNBNHHHNBNNBNBHHNNNNNNNNBNHBHNBNNHHBNNNNHHHNBHNHHHNBNN
HBNNHBNHHHHNHBBBNBHNHBNNHBNNHNHHHHHHNHNHHHHNNNHNBHNHNBNBHHNNBHNNHBBNBHNNNHNNHHNNNHHBNBNHNHNNBNNBHHNB
BNNNNNBBNNHNNNNNHBBHHNHNHHNNBNHBHBHNHNBNNNNBNHBNHBHNNBBHHNHBNBNHHNNNHNNNBBHNNNNNNBNBNHBHBHNNHHNNHHBH
NNHHNNNNHNNNHNBHNBNHBNBHNHNBNHNHBHNNHBNNHHNNHHNNHNNHNNNBHNHNHHNBNNHNHHBHNNNHNNNHNNBHBHHHNNNNHHNHHHHB
NNNNNNNNNHNBNBHNBBNNHHNHNNHBHNHNBHHNBHNNHHHHHNBNHBNHHNHNHHNHHHNNNHNHNNBBHBNNBHNNNNNNNNNNNBNBNBHNNNHN
NHNNBNBHHHNNHNNNHHNNNNBHHBNHNBHHNHNNHHHNBNNHNHNHNBHNNNHHHNHNBNNNBBNHHNHHNHNBBHNBHHBHBNNBBHBNHNNHNBNB
NNNHHNHBNNHNHBHBBNHBNNHBBNHBNBNHBHBNHHNNBNHNBHHNBHBHNNNHNHBHHBNNNBNBNBHBHNNBBHBNNBBNNBBHNBNBNNBNBNHN
BHHNNBHBHNBNNBHNBHBBBHNHBNNNHNBBHNHBHNNBHNNHHNBNNNBHBNBNHNNHNNNNHNBNNHBNNBBBNHNBHHNNNNNNHNBHHBBBHHNN
BHHBNHNHNHHHHNNNBHNNBNBBNBHBNNBHNNHBNBNNNHHNBNBBNNNNHNNNBNNNBBNBNBHNNNHNNBHBHHHNNNHHNNNBNBHHNNHHNNNN
NBHNNHNNNNNNNHNNNHNHHNHNHNNHBNNHHHHNNNHNHHHHNNHHNBNHHNNBNHNBNHBHNHNHNHNHHNNHNNHBNHNHNBNBNNHBNBHNHHBN
HBHHNNNHBNNBNNHBNHHNNHBNBBNNHHBNHNNNNNNBHNNHHNNNBNBNBHHNHNNBNNHHNHHHNHHHNNNBHHNNHNNHNNHHBHNNBNNNHNBH
NNNNBBNHHNNNNBBNBNNNNBHNNNNNNNHBNNHNBBBNNNHNHNNNNHNNNNHNHHHNNHNBNBHBNHBHNBHHNNNNNNHHNBNHNNNBNNNHNHNB
NHNNNHBBHBBNBBNNNNHHHBNHNBNNNNBBHHHHHBNNHNNNNNHNHNHNNNHNBNHNHHBNNNHNHBNNNBHBNBHBNHBNNNBNNNBHNNBNNNNB
BHHHHHNNBNBNHHHBHHNHNNBNNNNNNNNBHNNBHHBBNBNBHNNNNBHNNNHNHHNHHHHHHHNNNHHNNHHNNBHBNNBNNHHHHNNHNHHNNBNH
HNBBHHBNHHNNNNHBNHBBNNBHNBHNNHHHNNBHHNNNNHNBNHHHNNBHBNHNHNNBHHNBNBNNNBNNBNBNNBNNBNHHHNHNBNHNHBHNBNNH
BNBNBNNNNBNNHBHBHNNHBBHHBHHNHNHNHNNBHNNNNHNNNNNBNBNBBNNHNHNBHBNHBNHNNNBNHNNNNNNBBNNHBNHNNNBHBNBNHBNN
BNNNNNBHBBHHHHNNHNNNBNNBNNHBBHHNHBBNBNNBNNNHNNNNNHNHBNHNNHNHNBBBNHNNBBNHNBBNNNNHHNNHNBHNNNNBBNNNNNNN
