HNBHHBHNNHNNHNHHHNNBBNHNNHBHBBNNHBBHNHBNNNNHBNNNNNNBHHNBHBNBBNBNNBNNHNNBBBBNHBHHHHBHHNHBNNNHNNBNBBNN
NHNNNNNBBNHBNNHBNNHNNBNHBNBNNNHHNHNNHBBNBBBHNHBNNHHHNHHHNBHNNNHHNHBNNNNHBNBHHBNHHHHNBNHNNNBNHNNNNHNN
NNNHHNNNNNHBHHBNNNNBBHBNBBNBNBNBNHNNNNHHHNNNBBBHBHBNNBBNNNNBNNBNNNHNBBNHNNNHNNHNNNBHNNBNNNNHNNNNNNHN
HNBNHBNNHHNNNBHBNNNNNNNHNHHHNNBNHNNNNHNBNHHNNHNNNNBBNBNHNBNNBBNNHNBNNHBBNNNHBHHHHBHHNNNHNBNBBNHNNNHB
NNNNNHNBNHBHBNHNHNBNNBHNNHNHNNNHNNBHNNNHHNHBNNHHNNNBNHNNBNHBHBNHNHNBBNBNBBNNNNHNNNNNHHNHHNNHBHHHBBNN
BHNHBNNNHNHBNBBNNHHHNNNBNHHHHBHBNHHHBHNNHNHNHHHHHNNNNNHBBNBHNHHHHNHNHBBHBNHHHNNBNNNHNBNBHNBBBNBHNBNH
NHNHHHBNHBBNHBNNBNHBNNBNHBHHNBBNHNNNNBNNNNBNNBBNNHHHBHNHHBHHBNNNNHNNHNHNBHBNBNNHNNBHNNHBNHNHHNHNNBBN
HNHNNNNBHHNHHNNNNHHHNHBHNHNNHHNNHHNHNHNHNBHNNNNNNBNNNBBHNHBNNNHBBBNBBHHNNNNNNBHNNNHHHNNHHHHNBNNNHBNN
NBHHNBNHNBHHHNNHNNHBHBNNBNHBNNBHNNNNNHBBNNHNNHHNNNNNHBNNHHHNNNNNBNHNNBHNNNNNNHHHHNNNNHHNBHNNNNNHNNHH
NBNNNBNHNHNNNNBNHHNBNHHBHHHHNNHBBHBHNHNNNBBBNBNBNNBNNHNNBHNHHBBHNBBNNBBNNBHNHNHNBNNBBNNHNNNNNHNBBNBN
HBNNHHBNNHNBNNBHNHNHBNNNNBHBNNNNNBNBBNBNHHNNNNBBNBNNBBNNHNBNNHBHHNBBHBHBNHHHNHNNNNHHNNHBNNHNNHBNBNHN
BHBHNBNNNNHBHNBNNBNNHHBNNHHBHHBNNNNNHNNNNNNNNNBHHNNHNNHHNNNHBNBNBNNNNBNHNHNHHHBNBBNNNNNBHHNBBHBNNNBN
NNHNHNNBBHBBNBHNNHBNNBNNNBHNNHHNBHHBHBNNNHHHNBHHNNBHNHNBHNHHBNHBBBHNHHNNNNBBHBNNNNNNHHNHNHNHNNHBNNNN
BNNNNHNNNBBNBNNNBHNHBNNNBHNHHNNNNNNNBBHBHNBBBNNHHNNNNNBHBBHBNHNNHHNNBBHBHHNNNBHNNNNNBNNNHBBBBHHHHHHB
BNHNNHBBHBBHBBNBNHHBHNHHNHNHNNNNNBNNHHNBBNBBNNBNHNHNHNNNNHHNNHBNHHNHNNHNBBNBBBNNNBHNNHNBHNHBBBNNNBHN
HHHNNHHNHNBNHHHNBNHHHHHNNBNNNNNNNNNNBNNHNHHNNNHHBBNNBNHHHHBNNNNBNHHNNHHBNNBNNHBHBNBNHBHNHBNNHBHNHHNN
HBNBHNNNBBNNBNNBNNHHHNNHBNNHBNHNHNNHHBBNNNHNNBBHNNNBHNHBHNNHNHNNBBHBHHHHBHNBNNHBNNNHNNBNHBNNNNBBHNNH
NNNHHBBNHBNHHNHHHNHNNNNNHBNNNBHNHNNBNNNNNNNNHNNBHBBNHHNBBHNNNNNNHHNNNNBBHHHHHHNHNHNHBNBHNNNHHBNBNHBH
HNBNNBNHHNNNBNHBHNNBBHHNNNNNNBNBNNBHNNNNHBHNNHHNNNHNBHNNBNNBHNNBHBNNNBNNHNNBHNBNNNHBBNNNHNNNBNNNBNNH
BBNNBHHHNNNNBNBNNNHNBNHHNBNHNBBBHBNBNNHBHNNHNHNBBNBNNNHBBHNNBBNNHHBNNBBNBBBNNBNNHBNNNNBBNBNBHNNNBNBH
NHHHHBHBHNHNHNNHHBHBBNHBNNBNNNNBBNNBBNNHNBHNHHHNNNNNHNHNNHHNNBNNHNHHHBNHNNBNHNNNNHHHHHBNNNNNNNHHHBNH
NBBNNHHNBNBNBNNHHBBNNNHNBBHNHNBBNNHHNHNHNBBHHNNHHNHNNNBNNHNNNNBHNHNBNNNNHNNNBNBNBNNHHNNBNHNNNNNNNNNH
NHHHHNHHNHNHHHNHHHNBNNNHBBNHNNNNBHNNNNNHHHBBBHNHHNNNHBHNNHNNNHHNHNNHHNHNNNHNNHBBNNNNNBBNHHNNBNNNNHBH
NNBNBNNBHNHHNHNHBNBBNBNNBBNNNNNHNNNHBBBNNNHNHBHBHBNNNBNHNNHNNNNBHHNNNHHNNHBHHNBBNNNNHNNNNHNHNBHNNBHN
HHHBNNNNNHHNNNNHHNNHBHHNHHNNBNBNHHBNHHBNBHNNNHNBHHNBHNHBNNNNNNNNHBBNBNNHNNNHNNNNBHNNBBNBNNNBBHNHNNHN
HNHNNNNHNHNNHNBNNNNNHNHHBNNNHHBNHNHNNNHNNNNNNNNNHHHNHHNHBBNBHNNNBNNBNNBNHNBNBNHHNNHHNHNBNNNHNHNNBHBN
NNNNHNHNBNNNNNBHBHNNNBBNHBNHNHNNNNNNBNHBNNNHBBHHNNHNNBNNNNNHNHBNNBBBNNBNNHNNBHNHNBNHNBNNNHBHNNHHNNNH
HHNHHHNNNHNNBNNBNNNNBNNNHNHBNHHNHHHNBNHNNHNBNHHHBBHBNNNNNHNHNNNBHHNNBBNBBHHNHNNNHBNHHHNHNHBNBHNBNNHB
NNNNHBNBHNNNHNHHBNBNHNNHNBHNHNNHHNHNHNNNHNHNNBHNNNNNBHHHNHHBBNNNNHBHBNHNNNHNBNNBHHBNNNHNBHNNHNNNHNNH
NNNHNNNNHNHBHBNNNHNNNHHHBNNBHHNNNNNNNNNHNNHNNHNHNBNNNNNBNHHNHBNHNNHBNHNNHBHNHNNBHHNNNNHNNNNNNNBNHBHH
NNNNBHNNNHHNHNNNBHNNHNHBBNNHNHHBHNNNNNNNNBNBNNBNHNNHNHNNNHNNNNBBBNNBNNNBHNNHNNNBNBHNHNNHNNHNHNNHHBHB
NHNHNBHNNBNNBBBHNHBHHHNNNHNBNHNNNNNNNHHNNHBNNBBNBNNNNNNBHHNHNNNHNNHBBHNNBBHNNHNBHNNNHHNNHNHNNBHNNNNH
NBBNNNBHNBNNHHNNHNBHNHHNNNBHNBBHBNBHBNHNHHNNBHNHBNBNNNNHBNHBHNBHNBHBNNHNHHNNHHNHHHBNNHNBNNHNNNNNHBBH
NHNNNBNHNHBNNNNHBHNBBBHNBNNNNNNHNNNNBNHHHBNHHNHNHBBNNNNNBNNHBNHNHBNHNHHHNNNNNHHBNBNBHBNHNNHNNHBHBNBN
HNNNNNHBNNNNHBNBNNNNNNHHNNNNNNHNNNHNNBHHBHBBNNHBNNNNNNNNNBBNBHNNBNHHBNBNHBNNNBHBNBHHNHNNHHNBHBNBHNBB
HNNNHNHNNHBNNHHHNBBNHHNHNHHHNHNBHBNHNBNNBNBNNNNHNNNNNHBNHBBHNNHNNNNHNNNNNHNHNBBNHBBNBHNHBNBNHBHHBNHH
BNBNNHHHBHNBHNNHBNHNNHHHBNNNBHHNNNBBHBHNHNHNHBNNBHNNBBNBNHHHHNHNBHHNHNBNNNBNBNHNNNNHNBNNNNNNBNNNBBHN
HHHNBNNHBNNNBNNBHHNHBNBNNNHNHNNBNNBNHHNNHNHBHHBBBHNHNHNNBBHNBNNBBNBHNNNBBHNHNNNBNNNNHBHBHBNHNBBBBHNN
NNHNBHNNHHNBNNBNNNHNHBBNHBNBHBHHHHBNHNHNNBBHNHNNBHBNNNNHNHNBNNNBHNNBNBHNNHNBNBNBHNNNNNHHNBNHHNBNHNHB
NNNNNBNBNNNNHHNBNHBNBHNNNHBBBNBNNHNNBBNNBNNNNHBHHHNBNBHHNHHNNBNNBNNHBHHBHNBNNNHNBHNNBNNNHNHNHNNBHBNH
NNBNNNNNBNHNHHHBBHBNNNBHBNNHBHBNBHBHBHNBNHNHHNNNHHNHHHNNBHNHNNNHNBBHNHNHNNNBNHNNBHHBNNNNNHHBNHHBHNNH
BNNNNNNNBBBHNNBHNNBNNNBNHBNNNHHBHNNNHNHHHBBNNHHBNNNNHNHNHBHBBBNHBBBNNNNNHBHNNHHNNHNNBHNBNNNHHNNHBNNN
NBNNHHNBNBHNNHNBNNNNNHHNBNHNHNHHNNNHNNHNBBNBNNBNNNHNHHHHNNNHHHBNNBBNNHNNBNHNNHNNNNBNNHNHNHHNBNHHNHNN
NNBNNHNBNNNNNHBNHNNHHHNHHNNNNNNHNNNHNHNNBHNNNBNBNNHBNHBNHNNHNNHNNBNBNNNHNBHBNNBHBNNBNNNNBNNNNNHNBHHN
NNBHNBNNBNHNNBNNNNNNNNHNHNNNHNHNNNHNHHBNNNHBNNBNNNHNNNHNBHNBBNHNNNHNHBHHNHBHBNBBBHHHNHHNNNNNHBNNBBHN
NNBNHBHBNBHNBNNBHHHHBNHNHHHBBNHNNNNNHHBHHNHBBNNHBNHNHNBHHNBNNNNNNNNHBHHNHHNBNNHHBNHBHHNNBNHNHNNBNNBB
NHBNBHNBHHHHBNHHNBBNNNHNBNHHNNNHNNHBBHHNBHHHNNNNHHHNNNBHNHNHHNNNNBHHNHBBBHNBBNNHHNHBHBNNHBHNNHBBNNNB
BHNBNNBHNBNNNNNNHBHNNNHHHNBHNNNBNBNNBNBNBHNNNBNNNBBNNBBBHNBNHNBBBNHNNHHHHBBNHHBNHNNBNBBNHNHNNNHBBHBB
NNHNHNNNHHNNHNBHHNHNNNNNNHBNNHNBHHBNBBNNHNNHBNNNHBHHNBNHHNBBNBHNNNNHNHNNNBNNBNNHHHBHNNHNNNNHNNHNBBNN
HNNHNNHNNHNNNHNNNNNHHNNNNHBNBNNBNNNBBHHBNBNNNBNBBBHHNBNHHNNNHNHNHBHNHBNHHNNHNNNNHNNBHNHNNNNNBHNNHHHN
