HBNBHNNNNNHHNHNBBHHNNNHBHBHBNNNHNNNHHHHNHHNNHNHHHBNNNHNNHNBNNNNBNHNNBNNHNNNHNNHNHHHBBHBHHBBHHBNNNHHH
BHBNNNBNHBHNNHBNHHBHNBNBHBHHNNNNNHBNNHNNHNNHNNNBNBNHBBHHHNNNNNNNNHNBNHHHHNNHNNHHHBNNHNNNNHHHHNBHHNBN
NNNBHNHHHHNBBNNNBHNBNBNHNHHBHHBBHBNNBHBBNNHHHNHHNBNBHHNNNNNNNHBHNNHBNBHHHNBNNBNNNBBNHNNBHNHNNNHNHNHH
BNHBBHNNHNBNBNNHNBNNHNNNNNNHNNBHHBHHHNBHNNBNNHHNNHBHNBHNHHHNHNHNNNNHBNBBNHNNNNNBHNHHBBNHBNBNNNHNBHNN
NNNHHNNNBHBNHNBBHNNNNNNNNNHBHHHHHBNNNNNNHNBBHNNNNBHNHNHBNHNBHNHNHHNHNNHNHNNHNNHHHNHHHHHNHNNBNNNNHHNN
NBHNBNHNHNHHNNBBNHNBBNNHHNNNNNNNHNHNNBHNHBBHNNHNNNHHBHHHNNBHBNNBHNHHHBHNNBNBNNNHHHNBNHNHNNBHNNHHNNNB
BHNNNNBNNBNBBNHHHHHBHHHNNHNNHHBHHNNNNNNBHHHNBNHNNBNNHNNBBNHBHNNNNBHBNHHBNNHHHBNNNNHNNBNBNHNHHNBNNNNN
BNNHNHNHNNHNBBNBBNBNHHBNNNNHNNHHNNHHNNHBHHBNHBBNNHNHHHHBHBBHNHNBBBNNHBBHNNBNNBNBHHHNBHNHNNNNBHHHNHBH
NNNHNHBNNHNNBNNNNNHHNNNNHNHNNHBHBHNNNNHBBNBNNNNNBNNNNBNNNHNNHNNNBNNNHNHBNNNNNHBHHNNHHHHNBBNHHHHNHHNN
NNNHHNNNNNNHNNBNHHNBNHHBNHNNNNNHNBNNHNHBBHBHBHNHHNHBHBNHNBNNNHNHHNHNHBNHNNNNNHNHHBBNNHHNNNHBBHHHNNBN
NBBNHBNHNNHBNNHNBHNBHNNNNNHNHHBNHHHHNBBHNNNBHHNHHNNNNBBHHNNNNHHBHNHBHHBBHHHNBHHHHBNNNNNNHNNNNNBHBNBB
BNNHHBHHBNHHBNHBNNNHHNNHHNHHNNNNHNHBHBNNNNNBNBHHHNBHHNNNHHNNNBNNHBNNNNHHNBBBHBHNNNHNHHNHBNBNHBBNNBHN
HNBHHHHNNHNBNNBNNNHNNNBNNHBHHNNBHNNNNNBBBHNHNNHHHHHBNNNNHBBBHNNNNBNNHNBBHHHBHNNHHHNHNNNNNNBHNNHHHHHH
NHNHNNBBNHBNHBNNNNNHBHHBBHBHHHHHHNNBNNHNNHHNBHHNNNHNHHNNHNNHHBNHNHNNNBNNNNNNBBHBNNNHNNNHHNNNNNHBHHBN
BNHHHHBHBBHNNNNHBHNNHHNBNHHHNNNBBNNHNHNHBNBNNNNNNBNBBNHNHBBHHHNHNHNHHBNHNHNHHHNHBNBNNBNNNNHHBBNNNNHN
BNHBNHHNBBHNNNHBBNNHNHNNNHNNHNNNNHNNBNHNBNNHHHHNNNBBNHNNHNBHNHNHNHNNNNNBNNHNHNNHNHNNHHNHNHBNHNHNNNNN
NNNHNNHNNHBNNBHNNNNNNNNHNNHHNBHBHHBNNNHNHNNNNNHBHBHHNNBNNHHNNBBNNNBNHBBHNHBNNBHNNNNNHNNNNNBHNHHNNHHN
NHBHHHBHHNNHHNHBHNNNNHBNNHNNBNNNNBHNHHNNNBNHNHNNHHHNNNHBNHBBBNHHBHHNHBHNNNHNHBBBBNHNNNHHNBNHHNHHHBNH
BBNNBNNNBNBHNNBNHBBBNNBNBHHNHNNHNHHHBBBNNNBBNNHNNHNNNHNBBBHNHNNBNHNNHHHNHNHBHHNHNNNHHNHHNNNBBNNHHNHN
NNNNHNHBHNNBNNHHBHNBHNNNHNBHNNNNNNHNNNNNNHHNHNHHHNHNNBNHNNHHHHHBNHHNNNNNNNHHBBNNHBNHHHHNNNHBNHHNNBHN
HHHNBBNNBNHNHHNNNNBBNHHHHHNHNNNHNNHBNNHNHNNNBBNBNNHHHBNNNNNBHNHBNNBBNBNBNBNHHHNNBHNHHNHBBNHBBNNBBBNH
HNHHBHNHNBBHBHNNHHNNNBBHNHHNNBNHNNNNNNNNHNHNNNHNHBNNNBHNNNHBHHHNNHBNBNHHHBNNHNNBBBNNHHHHNBNNBNBHHBHN
NHHBNHNHNNNHHNHNNNHNBNNNNHBNNHHNNBNHNNHHHHNHNNHHNHHNBBNHNNHBNBNNHBNHHNHNHBNBNHBNNNBHHNBNBBBNNBNHBNNN
BNHNBNHNHNNBBBNHNNHBNHNBNNBHNNHHBNBNNNHHNHNNNBBBHNHNBBNNBNNHHNNNNHNNNHNBHNBHHBNHHNNNNNBNHHNNNNBBNNBB
HNNHNNHHHBNNHHNHBHNHHNHHBBHNNNBBNNNHNHHNHBNNBNHHNNNHHHNHBNHBNBNNNBNNNNHNNNHHNNNNBBNHBNHBNHHBBHNHNNNB
HHNNNBHNNNBNNHHBHHHBHNNNNHHNNBNHBHBNNHBNBNNHNBBNHHNNNHBHNHNNHHNNBNHNNNNNNHNNHNNNHBNBNNHHNNNNHNHBNNNN
BNHHBHNBNNHBNBNNNNNNNNNNNNHNHNNNNHHHNHBNBHNNBNNNHHNBBBNNNHNNHNBNNBNHNNNBNNNNHNHNNNHNHHNHHNHHHNNNHNBB
HNNNNNNHNNNNHHNBHNBHNBBNNNNHNBBNNBBNHHNNHNNNNNBHHHNNHHBBBHNNHNBNNBHBBNHNNNBBBBHBNNNBNNNNNNNHNNNNBHNN
BNNNHNHBNHNBHHNNNBNNHNNBHNNBHBHNBNHNHNNHBBNHBNHHNBHNHNNNHNHNHNHBNNNNNNHBNHHNNBHNHNBNNNNNBBHNNNNBBNHN
HHBNHNNNBNNBHNBBHHHNHNNBNNNNHBNHHNNBNNHBBBBNHNHHNHBNNHHNBBBNHNNNNHNHNNBNNNNNHBHNNNNNNHHNHNNBHNNNBNNN
NBHNNHNNHNHNNNHNHNNNNNBNNNNNHHBNHHBNHHHNBNNHNNNNHHHBNNNBBHNNHNBHHHNBNBHNHNNNNHBHNNHBBNNNNBBNNNHNNHNN
NNHNNNHBNNNNNNHBNHBNBNNHNHBNNHBHNBNHBHNBBNHNNNHBNNNNBHNNNHHBNHNBNNHBHBNBNNHBHHBNHBNHHNNNNHNBNHBNHNBN
NHHBBNHBNNNBHNBHHNBNNHNNNHHHNHBHNBHHNNNBNNNBHBNNNBBNNNBHNNBNNNBBNBNNHNBNNNNNHNNNNHHNBNNNNNHNNBHNNNHN
BBNNNNHHNNHBNNBHBHNNBNNNNNHHNNHHHNNNBNHBHBBNBNHNBHHNHHHBHHNHHNHHHHHNNNNNNHBHHHNHHNHHHBBHNBBNHBHNNHBN
NBNNNHHNNBBNBBHHBHNNNNNHBHHBNNNNNHNNBNNNHBNHHHHHNNNHNBNNNBNNNHBNNHBHNHBBHNNNNNNHNNNNBNHNHNNHBHHHHNNN
HNBNNBNBNNHNNHNBNHHNNHBHBHHBNNHBNBHNNNHNNBHNHNHHHHBHNNHHBNNNBNNNBBHNNNNNNNNHHHNNHHBBNNBNNHBNNBNNHNBN
NBNHNNHNNNNHNHHNNNBNHHHHHBNNNHBNNHNNNNBNHNNBNHNNNBHNNBNNNNNNNHHHHHHHHNHNHNNNBNNNHHNHNHBHNBHNNNNBBBNN
BNNBNBHBHNNBNNNHNHBNHHBHBNBHHBHNHHNBNHHHBNNHNNHNBNNNHBBHHNBNNHNHBBHNHNNNBBHBBHBBNNBNHHNNBNNBBBBBNHNH
HNNBNNNNBNNNNNNHHHNBNHNNHHNHBHNNNNBHNNNNNNHNHHHNBHNNNHNHNNHNHBNBBNNHNHNBNHNHBNNHNNNHBBNHBHHNNNNBBBNN
BHHHNHNBBBNHHNNHNNHNBNHNNBNBHHNNNBNHNNBNHNBHNHNHNHBNHHNNHBNHNBBHHNNHBNNBNNNNHHHHBNNBNBBHBNBHNNHHNNNN
BNNNNBBNNNNNNHHNHNHNNBNNNNBHBBHBNNHHHBHNHHNNNNHHBHBHNNNNBHBBNHHHNHBHNNNNBBHNNBNHNNHHNNHNHNNNHHHNHNNH
HHNNBNNNNHNHHNNNHHNHBNBBHHHNNHNNNBNNHBHNBNBNBHNBNBHNHNHHHNNNHHHBHNBHNHNNNBHHHNHBNNNBNNNBBNNBNHBNBNNH
BNNHNNNNNHHBNBNNHBNNHNNNHBNHNHNHBHBBHBNBHHNBNNBNBNHBHHNNHBHNHNHBBNNNBNNNNHHHNBHHNNHBNNHNHNHNBNBNHBHH
NNHNHNBHNNNNNHNBNNHHHNHNNHHBNNHHBHNNHNHNHNBHBBNBBNHNHNHBNNHHHNHNNBBNNNNNNNNHBHNNHBNHNHNBBNNNHBHHHNHN
NNNNHBNNNHNNHBNNNNBHBHNBNHBNHHNNNNHHBHNHBNHHNBNHHNNHBNNNHBBBNNNHBNBHNBBHHBHHHHNHNBHHBNNHNNHNNBBNNBBN
HNNNNBNHNHNNNNBNHNHHBBBNHNNHBNHNNHBBNNNHHHNNNNNHHHNNHNNNHNHNNNBNNNBBNNHHNBBHHNBNNHBHNNNBNHBNNNNHNNBH
HBBHBHNNNNHBHBBNNNHBHHHNNNNHHNHBHNHHNNNHNHNBNBHHNHHNNNBHNNNNNHNNHHNNHBNHHHBNNBHNNNHBBNNHHHNHNNHNHNNB
HNHBHNNNNBHBNNNNBNHHNNNBNHHHNNNNNHNNNNBNNNHNHNNNNNNNHNNNNNNNNHBNBBNBNNHNBBBHNBHNHNNNNHHHHNNHNNNNNNNH
HNHBHBHBNNHBNNNHBBNNBNNNNNNNHHBHNNHBBNHBNHNBNHNHNBNHHBNBHHNBHNBNHHHNBHHHHNNBNHBNNNNNBHNBBHNHHNBBHBHH
HNNBHHHHNHNNNBNNNNNBHBNNBHBBNNBBNHNNHNNNBBNBBNHHNBNNHNBBNHHNHBNBBNHNNNBHHHHNNNNNHHNBBNHBHHNNBBNHNNHH
