BNNNHHHHNNNNNNHBHNBHNNNNNHHNNHNHNNNBNHBHNNNNHHBHNHHHHNNNBBNNHHNNHHHHNNHNNNHNNNHHHHBHNBNNNHNNNNNNNNNB
NNHHHHHNNHHHHNNHBNNNNNBBNNHNNHBNNBHNHNBHNNNNNBNBBHHHBNNHNBBBHHNBNNBBNHNNHNNHNNBHBNNNNNHBHNNNHBBBNHHB
BNNHBNBNHNBNBHNNHNHNNNBNNHNNBNNBNBHNHNHHHNHBHNBHNNHHBNNBHHHBBNNBNHNNNNNHNHNNBHNHNHBHNNHNNHHBHNNHHNNN
NBNBNHHHHHNBHNBBBNNNNBHBHHNNNNHHBNNNHNNHNHNNBNNHNNNNNBNHHHBBNNNNNHHHNNNBNNHHHBNNNHNBNNNNHNHNNNNNBNHB
NNNHHNNBNBBBNNHNNNHHHNHHNBHNHNNNHHNBHNBHNNNNHNNNHHBNNBBBHNHHHHNNNBHNBNNHBHNBBHHNNHNNNNNBNNHBHBNHBNNN
HNHNHHHNNHNBHNBNNNNHNBHBBNNBBNHNNHNNNBBHHNNHHHNHNBNNNNHNHNHBBHBNHNHNNHNHBHBHHNNBHBHHBBNBBNNHBNHHNBBN
HNHNHHHNBNNNHNHNBNNBHNNNHNNBHBNNNBNNNHNBNNNNNBHNNHNNNBHNHBNHNNBNHHNBHBNBHBNNBNBHNNNHHBHBNHNHNHNHBNHH
NHNNBHNNNHBNBNNNBHBHBNBBNNHNHHNNNHNNNHNBHHNNNNNBNBNBNNBBNNBNBBBNNNNNHBBNNBNNHBHHHNBNBBNNBHBNNNNHNBNN
HBHBBBNHBNNBNBNBNNNHHHNNNNNBHNHNHHBBHHNBHBHNHNNBBNHHHNNHBBNHNNHNNNBBNHHBHNNHNHBNNNNHHHHHHNBHNNNNBHNN
NBHHHHNHHBHNHNNBBBNNBNNNBNNHBHBNHBBNHBNNHNNNNHBHNHHHNHHNNHNHHNBBHNHNNHNBBHHBBBHHBHHHNBBNHHBBNHHHHHBH
HNHBHNHHNHNNNNHNBNBNHHBNHBBHNNBBNNNBNNHNHBBNNNNNNNNBNBNBHBHHNNHBBHNHNNNNBHHNNHNNNNHNBNHHNBNNNBNHNNNN
BNNNHNNNHHNBBNBNHBNHBHBNNBHNHBHBNBNHBNHNBHNNBBNNHHHNBBNNHNHNBNNBNNNNNNHBNHHHNNHNHNHBHNNHHNNBNNBNNNNH
NBNNNHNNNNHHNNHNNNBNNHHNHNNNHBHBHNBBHBHNNHNNHBHNNNHNNNNHNHBNNBNNBHHBHBBHHNBNBNNBBNHNNHNNNNNBBHHNNHHN
HNHHBNHNBHNHNBBNHNNNNHBHHBNNNHNBHNNBNHNHHHNNHNNBBBNNHNHNNBHNBBNHNNBHBNHBNBNHHNHNNNBNBHHNBNHBHNBHBHNN
HNBHNNNHNNBBBBNNNNNHNBNBHHHNNNNNHNHNHNNNNNNNHNNBNNNHHNNHBNNHBBHHBNNBBNNNBNNBBNHBNBHNNHHNNHNBHHHHNHHN
HNHNNHBHBHNNNNNNHNNNNNBNNNBNBNNNHHNBNHNHNBHNNHHHBNNNNNNNHHHNNNHNHBHNNHNHHNBHHNNHBBBHHNNHBHNNHNNHNBHH
NNNHNHBBHBNNNHNNNNBHHNBHHNNBBBNHNHHHBHNHBNHBBBNNHNBHHHNNNBNBNHBBHNNHNNBHNNHBNNNHNNHHNNBNBBHHNHNNHHHH
NHNNHHBNNNNHNHHHBBHHNHNNNHHNNNBBNBBHNNBNHNNHNHHNHNHHBHNHHNNHNNHBNNNNNHNBNHNBBBNHNHBBNNNNNBHNBNNHNNHN
NNBHBHHNHNHHHHNNNHHNNNNHHNHNBBNBNNNHNNHHNNBBNNNHNNNHBBHNNHNNNHNBHNNNHHBNBHBHHNBBHNNBNNHHHBNNHNNBNNNN
NHHHBHHNHNNHBNHNBNNHBNNNNBNBHNHNHNHBNHNBHNBBNNHNNHNHHHHHBBNBBNNHNNNNNHNNNNNNNNNHNHBNHNNNNNBHBHBNNHHH
HNBBNBBNHNHNNBNBNNNNNHBNNHNHBHNNHHBNNHBNBBNNBNNHNBNNNBNHNNNNNHNNNNBNNNBHBHNHNNHNNBHNHHNHNHNBBHNNHNHH
HBBNNNNNBHNBHHHBNNBNHBBHHNNHNHHHBNHNBHNNHNHNNNHHHNNBHNHNHNNBHNNBBBNBNNBNNBNNNNBNNNNHHNNNNNBNNNHBBNHH
BNNNBBBHNNHNHBBNNHHBHHBHBHBBHBBNNHNNNBNNHNHNNNNNNHHNHHNNHNNHBHHBBNNBBNHHBHBNNNNBNNHHHHNNHNHNBNBNNNHN
BBNNNHHNNBHNHHNHNNNHNHHHNNNNHNNHNBHNBHNHNHBNNNBNNNNHNNBHBNNNBHNNNNHBBBNNNBHNBBNNNHBNNNNHBNNNNBNHHNNB
NHBHNNBHNBNHBHHBNNBBNHBHNNHNHNBNNBNNNNBNHHHNHNNNHNNHNNHBHNNHNHBBNNNNNHHHHHHNNNNHHNNHNNNNBHNNHNNBHNNN
NNBHHNBBHNNNNNNHNHNNBNBHHHNHHNBNNHNNNNNHNHBNNHHHNBBNNNNNHNNBNBNHNBBBNHNBHHNNNBNNBBBBBNNNBNNNHHHNBBHH
NNBNHBNNBBBHBNNNBHBNNNNBBBNHNNHNNHHNNNBHNHBBHHHNBNBNNNNNHBBNNHHBNHBHNNNBNNNHNBBNNHNNBNNHNHBNNBNNBNNN
NBNNHBBBNHNNBBNBNHBNNBHHBBHNBNNBNHBBNNNNNNHHBHHNNHHNHNHHHBNHNNNHNHNNHNNNHNNBHNNBHHHHBBNNHHHNHNNNNHNN
HHNNBNNNHBHNHBNNBNNNBHBHNHNNNHNBHBBBHHHNNNNHBHHNNNBNNNNHNNHNHBNNNBNHBBHHBNNHHNNHNNHNNHHHHNNHNHNBHNNN
NHNNHNBNNNNNBHNHNHNNHNNNHNBBNHBBNBHBNNNNNNNNHNNHHNHNHBHHNHNNNHBNHNNNHNBBNNNHHNBNBNNBNBHBBNNNNNNNBHNN
BHHNHHNNNHHNNHNBNBNBNNNNNNHHNNBHNNNNBBBNHBHHBNNBNHHNNNNHBBHNNNBHNHNNNHNNNBHBHHNNHBHBBNNNNNNHNNNNHNNH
HNHHNNNBHNNHNHNBNBNHBNHNNBNNBBNNNHHHHNNNNNBNBHHHBHNNBNNNHHNNHNHHNHNNNHNHBBBHNHBBBBNNHHHNNBBBHNNNNNBN
NHBBHBHNHNHHHNNNHNBNHBHBBNHNHHHNHNNHNHNHHHNBNNNBHNHBBBNBNBBHHNHHNHHBHHHHHHHHNHNBBHBBHHNBNNNHHNBNBNBN
HNNNHHNHNHNHNNNBHNHBNBNBHNHBNNNBBHNNNNBNBNHHNNBBNNHNHNNHNHNNNBNNHNHNNBBBHBNBBHHBBNNNHBHHHNNHNBHNBHHH
HHNBHNNNBNNBNHNNHHNNNNBHHHNNNNHNNHHNNNNNNNNNNHBNHBNNNBHHBBNNNNNNHNHNNNBHHNHNHHNBNBBHHNBBBNBHNNHNNNNH
BNBHNHNBBBHHBNNHBNNHHBNNNNHNHNNNNNNHHNHNBHBNNNNNNNNNHBHNNHHHBHHNBHHBNNNBBNHNHHBBNHBBBNBHBNNHNHNHBBNH
HNHHNHNNBHNHNHHNHBNNHHHNNHNNHNNNBHHHBNHBNBHHBNHNNHHHHBHHBNHBNNNNHNNNNBBNNNNBNHHHNNNHBNBHHNNBNNNBNBHB
BBHNNNBHHNNHNNNBNNNNHNHHNBNBNHHHHHBNNHBBNNHHHNNHNHBHNHNNNNNBHHNHBBHHNHBNNNNNHNHNNBNHBNNNNHBBNBNHNNNN
NNNNNNNHNHBHHHNHHNHNHNHNHNHNNBNNNNHNBBHHHNHNNNBNNBNNHNHNNHHBBHHNBNHHNNNBHNHNHNNHNNNBBBHNNNNBHHHHNNBN
BBNNHBNNBNBNNHBBHHBNNNNNHBNNNNNNHNBHNNBNNBNBHHHNBHNHHHBNNNNHBHHNNHNHHNNNNBNBNHNHNHNHHHNBHBBHNBNBBNNH
BHNHNNNBHNHHHNNHNHHNHHNHHBNNNHNNNNNNHBNBNNNNNHHHBBBNBBNHHNHNNHNHBBHNNHNHBBHNHHHNHHHHNNHNBHBHBBHNNNNN
BNBBNBNBNNNHHBHBNNHNNNNNBNNHNHNBNNNBBHHNHBHHNBNHNBHHNNHNNNNNNNBHBHNHNNHNBHHHBBBNBNNBNNNHBNNHHBNBNNNB
NNBNHNHNBNNNNNBHNNBBNNBBNNHHNBNHHNHNHBNBHHNNBBHNNNNHHHNNNBNHHNNBNNNBBNHNNNNNNNHHNBBNNHBHBBBBHBNHBNNH
HHHBBBNHHBNHHNHBBBHNHHHNNNNBNNBHHNHNHNHBNNHNBHNNBNHNNBNNNHNNHHHNBBNHHBBBHNNBHHNNBNNNHNBBBNNHBNBBNNNH
HNNNNNNNHNHNNHNHHNNNBHNBHHNBNBNNNBHHNHHNHHHNBNNHHHBHBNNNNHNBHHHHHNNHNNBNBHHNNNNHHNNNNNBNNHNHNBNNHHNN
NNHHHHNHHNNHHNBNNNNNNNHHNNHNNNNHNNHHNBNHNNBBNNNNBNHBHBNHHBHBNNHHHHNHNNHNNNNNNNNNNNNNNNNNNNNHNBBNNBHH
NNBHHHNHHNNNHHNHNBBHNNNHNNHHNBNHNBNNHNHBNBHHBNNNNNNNNNHHBHNNHBBNHBBBNBHBNHHNBHHBNBBNHNNNHBNHNNNNNNHN
BNBNNNNNBNNNNHHNNNNHHHHHHBNBBBNHBNNNNBNNNNHNNNNBHHHHBNNNBNNBHHHBBHBNHBNNHNNNNHHNBHNNNNBNBBNNNHBBNNNN
NNNBNBNBNHHBHNHBHBHNNHNHNNNNNNNHNNHNNHNNNHBBNNNNNHHHNNHNNBHNHNNHNNNNBNNNBHHNNNHNNNNHBNHHNBHNHBBHNHNN
NNNNBBBNNNHNNHBHNHHNBNHNHNHBHNNNBNBNNHNHNNNNNHBNNBBNBNNNHBHHBNNNBNNNBHNHNNNNNNHHHHBNBNNHNNNNNHNHBHHH
