NNNBNNHHHHNNNBBHNHHNNNNNBNNHNNBNHHHBNNNBHHNNHNNBHHNNHHHHNHNHHHNNBHHHNBNNNBNHHBHNHHNNBHNHNHHNHHHNBBNN
NNNBNBNNBNNNNBHHBBNNHHBHHNHBHNBBBHNNBBBHNHNNBBBNBHHNNHNNNNHHHHBNNNNNNNNHHBNNHNNHBBNNNNHHNHNBBHHHBNHB
BHNNHBNBNBHBHHBNNHHNNNNNNBHHNNNHHHHHNHNHNHNHNNHHHNHNNNNHNHNNNNNHNNNHBNNNNHHNNHHBNNNNBNBHHNHNHBBBBNNH
NHNNBHNHBNBNHNBHHNBBNHHBBNNBNHNNHBNNHHBBNHNNHHBHNHHNHHNNNNNNNHBNBHNHHBBBBNHBNNBNHNBHNBBNHNNNNNHNNNNH
NNNHBHNBNNBBNNNHNHNNHHNNNNHHNNHBBHHNBHNHNNHNBNNNNNNHHNNHHNNBNNHBBNBNNBBHNHBNHBNNNNHNNNBNNNHHHNNHBHHH
NNNNNNHNHNNNNHHNHNHNNBHHNBHNBNHNNHNNNNNBHHBHBBNHHNBNNHHHNNHNBBNNNNHNNNNHHNNHNNHNNNNNNNNNBNNBBNHHNNBN
NHNBNNHBNNBHNHNNHNBHNHNBNBHNNNNNBNHNBHNHBBNNBNHNNHHBHNBHNBHNBNBHBNBHNBNHNNNBHHNHNNHNNNNBHNBBBHNHBNHN
BNNBHNBNHNHHBNHNHNNNNNNNNNHHNNNNHNBNBBBNNHNNHNHHNBHBNNNNNNBHNHBHNNBHNNHNHNBHBNNHHNNNBNNNBNHBHBBHNHNB
NNHNHNNNNHHNNNNHBNNHHNHNBNHHNHNBNNBHHNNNHHNNNHHNHNNNNHHHHBNNHNNBNHNHHHBBNNNBHNHHHNNNHBNHHNNBNNHNNNBB
NBHHBNNNNNBBNNNBNNNHBBBHHNNNBNHNHHHNNHNHNBNHHNHBNHBNBHHHNNNNNNBBHNHHHBNNNBNNNHNBHHNNBBHHHNNNBHNBNHBN
NHNHBHNNNNHNHHHNBNNHHBHNNBNBHHBNNNHNHNHNBBHBBHHNHNHHNNNNBNBHBHHNNNNHBHNHBHHNHNHNNNHNNNHBHHNNNHNBHNHN
NHNNBHNNNHNHBHNNBNHBNNNHNBHNBHNNNHNNNBNNNNHHHHBBHNNNNNBNNNBNNHHHNBNNHHBNBBHNBNNBNNNNBNBNHBNNNNHBHBHN
BNNNNHNHNNBHBNNNBNNNNBBHBHBBNNBNNNNBNBBNNHBNHHHNNNNNNHHHNNBHHHHHBNNBNHNHNNNNBNNNNHNNNHNNNNBNBHHNNHNN
HHHBNBBNHHNHNNHNNHHNBNNNBNNHHNNBHNBBNBBNBBHNNNNNNBNBNHHHNBNNNNNNNHBNNBNBHNBHNNNHNNHHBHBBNNHNHNNNNBNH
HNNHBHHHHNNNNHHNHBNNNNHHNNBBBHHNNHNNNNNBHHNHNHBHNBBHBHNBNNNHHHNNHNNNHNHBNNNNHNBBNNHNNHNHNBBNNBNNNHBN
BBBNHHNNNHHBHNNNNNHNHHHHBHNNNNNNHNNNBNNNHNNHNNHNHHNNHHNNNHNNBNHNNNHNNHHNNHNHBHHHHNNHHNHHNHNNBNNHNNHH
NNNHNHNNNBNNNHNNNHNNNHHBHNHNHHBHNHNNNHNBNHBNBNNHBNHHNNNNNHHHHHHNHNNNNNHNBHHNNBBNBHNHNHNNHBNNNHHBNNNH
HNNNHNHNNBHBNNBNHHBBHHHHHBBHNHHNBNNNHNNHNNBNNHNHHNBBHBBNHNHHHBBHNNBNNNNBBHHHHNBNNNHNBBNNBHNHHHBBNNNB
NNNNNNNNNHBNNBNBHNNNNHBHNHNBBBNHHBNHHBNHBHNHBBNNNNBHHNBNHHNHHNBBBNNNNBHNHNHHNBBNNBNNHNHNNBBNNNNHNNNB
NBNHHNBNBNNHNBBNNBHHBNHNNNHHNNBHHHBNBNHHNNNHBHNNNNNBHNBHHNNNNNHNBNNHHHBNNNNNBBNNHNNNBNNHHNNNNNHHBBNH
NNNHBBHNNNBNHHHNHHNNNBNNBNHNNNNNNNHHHNNBNHHNHNHHHNNNHNHNNHBHBHHHHNHHBNNHNNHNNHNNNNNNNHNHBNBNNBNNNNHB
HNNNNNNHHNNBNBBBNNHNBNBBNHNBNNBHNNNNHNHNNHBNNBHNBNNNNHNNHNBHNHNNNBHNNHBBHNBNHNNNHNBBBNNNBBNBBBBNBNNH
NNHHBNHNNNHNNBHHNNNNNHBHHNNHNNNHHHNBBNBBNNNNHHNHNNHNNNHNHNBNHBNBBHHNBNNNNBHHNHBHNNHHBNHNNBNBBBHHHHNH
NHHNHHHBHNNHNNNHNHHNBNBBBNNBHHBHHNNNNNHBBHBNNHBBNNNBBNNNHNNNNHHBNNNNBNHHHNNHNHNNHNBNNHBNHHBBBNHBHHBN
BBBNHNNNNNNHBNNHNHNNNHNNHHNNHHNNNNBNNHHNNHNBNBBBNNNHBNHBBNNBNNHNNBBNNNBBBHHNNBNNNNHBBBNNBHHHNHNNBNHN
HNNHHNNBHNHHHNHBNNNNHHBHNNBNNNBBNNNNHNHHHNNBHNBNNNBNHHHBNHBHNHHBNBHHNNNBBNHHNHHBBHNNNHNNBNNBNNHNNHHN
BBNNNHNHNNBNBHNBHHHHHHNBNHNNNBBNBNHNNNNBNHBNNNNHNNNNHBNNHHNHNHNNBNNNHHNNBNBHBBBNNHBNNNNNHNNHBHBNNHHH
NNNHNNNNNBNHNBNBBHNHHHNNHNBNHHHBNHNNHBHBBHHNNHHBNNNBNHBNNHNHHHBHHBHNNNHNBHBNNNHNNHNNNBHNNNHNHNNNHBHN
NHHNBHBBBNNHHBBNNHNHBBBNHHNHNNHBNHHHNNBNNNNNBNNNNNNNNNNNNHNNBNNHBNNNHNHHBNNHBHNNNBNNNHNHNNHNHNBBNNHN
NHNBHNHBBHNNHNHBHHBNNBNHHBHHNNNHBNBHNHNHNHHNBNNNNHNNHHBHHNNHNNNNNHNNNNBNNNHBNNNBHBBNHBHNNNNNHBNHNNNB
HBBBNNHBNBNNBNBHNNNBHHNBNHNHNBHBNHNBHBBNNNNBNNNBNNNBNHHNNNNBNBHBHNHNNHNHNBNNHNBNBNHHNNBBHNHNHNNHBHHN
HBBHBHBNNNBBNHNBHNHNHBNNBHHNNHNNBNNHNNNHNHHNNHHHBNBNNHNNNBNNHNNNNNHNBBHNHBNHBNNHNNHNHBNNNNNHBNBHNNNN
HHBNNNNHNNNNNNHBNNHNNNNNHHNNHBNNHNNNHNHHNHNHNNBHBNNNNHBNNHNBNHNNNHNBNHHNHHNHNHNHNNNBHNHNHBNNNHNNNBBH
HBBNHNNNHHHNNNHNNNNNNNNNNNHBNNHNNNHHNNBNNNNNHBBHBBHNHNNNHNBHNHBHNNHHNNNNHNNHNNNBBBBHBHHBNNBNNNNNNBNH
HBNNBBNBNHHHHHNHNNNNBNNHBHBHHNNBNNHHBNNHNNNHNNNNBHNNNNHHNNBHHNNNHNNNHBNHNNNNNNBBNNHBHHHHHNBBNHHHNHNH
NNBHNNHHNBBNNBHNHNBBHHNHNBHNHHNHHNNNHHNNNNNNBHNHNHNNHBNHBHBNBNBHHNNNNBNNNNNNNHNNNNHNNNNNNBHNHHNNHNHH
NHHNNHHBNHNNBHBHHHNNNNNNNNHHNNHHHHNHNNNHHNBNNHNBNNBBHBHNNBHHNBHNNNBHHBHNBNBHNHNNBBNBHNNHNNNHHNHNNHHN
BNHNHBHHNBBNNNNNBHNBNHHNNNNBNNNHBNNNHHBNNHHBHNHNBHNNBBNNNNNBNNHHBNNHHNNBNBBNNBNNBBNNHNBNNNHBHBBNNNBN
HNNNNBHNHNHNBNHNBNNNHNNHBHHBNBBNHBHHBNNBHHNNHNHHNNHNNBHBBNBNHBHNNBHHBHNBBNNNHNNNNNHHNNNHNHBNNHNNNNHH
HNHBNNBNNHHHNNHNNHHNNBHHNHNHHNHBNHHBHNBNNNNNHNHNNNNNNHNBNNBHNHNNBBHHHHBNHHBHNNNBHNBNNNNNNNHNNHNNHNHH
HBHNNHNNNHHNBNNHBNHBNHHNNNNNNNNHHNNNHNNNHBNHHNNNNNNNHNNNHNHNNNNNHNNHNNNNNNBHBNNNBNBHNBBNNNHBHHHHHBBH
BNNNNHNNBHNNNNHHHHHHHHNBNNBNNBBHNNHHBNNNNNHNNBBHNHNHHBBNHHHBHNHNBNNHNNNNHNNHNHHNNNNNNHNHNNNHBNNHHHNN
HHNNNNBNNNBNNHNNNBNNBNHNNNNHNNBNBBHBNBNBHNHHNNNHBNHHNHNNHNHNHHHHHBNNBNHHHNHHHNNHNNNNHNHHNNNHHBHHNNNH
BBHNNNHNNHBNNHNHBNNNNHNHNHNBNHBNHBBNBNNNBNNNBBHNHNHBNBBHHNBNHHBNNBHBNNBNNBBBBNBNNHNHBNNBBHNNNNNHNHNN
NNNNBNNHNBNHBBHHNNNNNBNNNNNNHBNHBHNHNHBNBHNNBNNHNNBNNBBBNNHNHNHHBBBHBHHHNNNNHNNNBBNBNBNNNBBNBNHHNHHB
BNHBHNNNNHHBHHNNNNHNHNHNBNHHBNHHHHNHNNHHNNNBNNBBNBNHBNBNNNBBBHNNHNNNBNNHNNHNHNNNBNNNNNNHNBHBHHNHHHHN
NBHBBNHHNBNNHHHBBHBHBNBNHHHNHNBNHNBNBHNBNNHHBBHHHHNHNNNNNHHBNHBNHHNHHHHNBNHNNBBHNHNHNBHHNBNHNNBNBHBB
BBHNNNBNBNHBNNHNBBNBNBNNNBBBNNNNHNNNNNBNBBNNNNNNNHHHBBNBHNNNBBHNBHNNNNNBNBBHBNNNNNNBHHHBNNNNHNBNBHNN
HHBNHHNBNBNNNNNHNBNNHNHNNNNHNNNNHHHHBNBNBBNNBBBNBBHNHBBNNNNNBBNBNNNHBNNBNHNNNNNNHBHNNHNBNNNHHHNBNHNH
HHHBNHBNHBNNNNNBNHNHBNHBHBBHBHBNHNNNHHBBHHBNNBBNNBBHHNNHNNNNBNHHNNNHHHBNNNBNHNNNHNNNHNNNNBBHNHBNNNBB
