BNNNNBNNBNNBHBHHNHNNNNNNNHNNHHBHNHHNNNNBNNNNNNNHNHNBHHNHNHBNHNNNNHBNHNHHHBHHBHHNHNHNNNHHHNHNBNNHNBNN
NHNNHNNBHBNNNNNHNNBNNNNBBBNHHNNNHHNNHNHBHBNNHBHNBNNHHNNHHNNBHNNBHHNHNHNBNNBBHBBNBNHHHNNNHNHNBHHNNNHN
HNNNBNNHNHNNHHNNNNBNHHBHBHNNBHHHNHHHHNNHNNNNNNNNNHBHHHNNNBNBNNHBBNBNNHHNBBNBNBBNNNBBNHHHBNBNNNNNHHHN
HHNHNHNNNNNHNNNHNNBHBNNHBNNBNHNHBNNNHHNBNBNNHNNHBNNNNBNHHNNBHNNBNHNNNNHHNNHNNHHBBNBNBHNBNHHNBNHBBHBH
HHNHNHNNHHHHNHNNHHNBNBBBHNNHNBBNBNBNNNNNBNNHHNHNNBBNNBNHNNNNBNNHBNNBHHHBNHHBNBBHHHBBNNBBNHNBBNBHNNNN
NNNNNNHNNNBBNBBNNHNBHHNBHHNBBNHHNHHNNHNNHNNNNNNBBBNBBBHNHNHHNNNBNNNHNHHHBHBBHHNBNNHHNHHNHHNNBBHHNNNN
BNHNHBNNNBHNBNNBNHBNNHNBNHHNBNNHNNHHNNNNBNBHNNBNBBNBNNHBHHNBNNBBBNNHNNNNNBHNNNBNBHNHNNHNNHNNHNNBNNNH
BBHNHHBBNBBBHHHHHBNBNNNBNBNHHBBHHBHHNHHHHHHHNNHHBNNNNHNNNNBNNNNNNBNBNHNNBNNNHHBBHNNNBNHBNNBNNHHNNHNN
HBHBNNHNBHNBBHBHNNHNHNHNNBNNHNNNHHNNHNHHNNBBNNHHBNNNHNNNBNHHNHNBBHNHNNHNHBBHHBNNHNNNHBNBBNNNHBNBNHNH
BNNHHHHNNHNHNNBBHNHHHNHNNNHHNBHHNNBHNNNNHNNHNHHNHHHHHNHNBBNNNHNBNHBNNNHHBNNNHNHHHBBBNNHNNBNNBHHHHNHB
BNNHNNHHNNHHHNHNHHHNHNBNHHNBNNNHHBNBNNBHHBBHHHNNBNBBNHBNHNNNNHHNNBNHNBNHNHHNNHHNNHNNNNBNBNNNNHNNNBNB
NNHHNNNBNBNHHHNBNHBBHBNHHHHNHNNHHNHNHBHBNNNNNHBBBHHNHNBNNNBHBNNNBHBHBNBHNNNBBHNNNHBNNHBBBNBNBNHHNHNN
NNBNHNBHNNNNNHNBHBBHBBHHNBNNNBNNNNBHNBNNNHNBHNNNNBNHNNHBHHHHHHHHBNHHNNNHHHNHNHNNBNBNBHBHHHBNNHNNHNHN
NBNBHBNHNNNHBNNHBHNNHHNBHNBNNNNNNNHHNHHBBNBNNNNNNBNHNBNBNHNBNHNHHNNNNNNNBHNBHNNHNNNNBNHNNBHNNHNHHBHN
NHHHBHHHHNHNHNNNHNNBHHHBHNBBBHHBNNBHBNHNNBNNBNNNNNHNNNNNNBHNHNNBNBNBNNNBBBNBNNNBHHHNHHBNHNBBBNNNNNBH
HNNBBHNNNHNNNNBHBNHNNNBNNHHHNBNNNHHNBNNNHNNNNNHNBHHHBBBHBNNBHBNHNNNBBBHHNHHHHHNHHNNNNNNNHNHBBNHHNBBH
HBBNHNNHNBNNHHNBNNHBHHNNNNHNNNNNBBNHNNBNNNNNNNNHHNNNBHNBBNNNNNNNNNNHNNNNBNHHHNNNBNNHBNNHHBNBNBNHBHNH
NNNHNNNBNNHHNHHNNNBNHBNHNNNHBHNNHHNHBBNNHNHNNNNBNNNHBHBHNHNBNBHHBBNBNHNHHNNNNHNBHNBNBNNHBBNNNHHHNBHB
HBBNBNNNHBNBNHNNHBHHNHBNNHNNHNNBBHNNNNNBNBHNNNNHNNNHNNHNNHNBNBNNNBHHBHBHBHNNNNHNNBNBHNNNNNNHNNNNNHHN
HHHBNHHHNNNNHHNHHNNHNNNNNNNHNHNHNNBHHBNBHNHNBBNHNNNNHHNHNHHBNNNHNNBNHNHHNHNNHNNNNNBBNNNNHNNHHBBBBNNB
BNBBHNBHNNHBNNNHNHNNBNNNBNNNBHHBNNBNHNHNNNHHBHNBNHBNHNHHHNNNNNNNNHHNBNHNNNNNNNHNHBBNNBNHNBNNBBHNNBBN
HHNHNBNBNHBHHBHBNNHNNNNNHHNNHNNNNBHNNHNBHHNNNNBNNNNNHBBNNNHNHNNBBNHNBHNBHBNHBBNNBBNHNNNHHNNNNNNNNNHH
NNHNHNHBHNNNHBNNNNNNBNBHNNNHBHHBHNNHNHHNNHNNNBHNHNHNHBBNNNNNHHNNNHNHHHNHHNHHNNNNNBNNBBBHNNNNBBNHHHNH
NNNNHHNNHBHNNHHHHNBHNBNHHNBBHNHHHNHNNHNNBNNHNNBHNHHNNHHHHHNBHHHNBHNBBHNHHNHNNHHNNNHHNHBHNBHNBNNHBNNN
NHHNNHHHNNNNNNHBHNNBHNBNNHHHNHNHNHHBNNNBHBHNHBBBHNHNBNHNHBNBHHBNBHHNHNHHNHHNHHNNNHNBBNBNBNHHHHNHHNHN
HNHHNHNBNHBHHNBNHBBHNBNHHHNBHNNNBNNHBHBHHNBNNNHHHNNNHBNNNHNNNHNNBHNNHNBHBNNNHNBNBNNBNNNNNHHNBNNBHHHN
NNNHHBNHHNHBHNNBHNNNNNHHHNNNHNNBHNHNNNNNNHNNHHHNNNHNHNNNNHHBNBNNHBBHHNNNHNNNBNNHBHNNNBHNNBHHNHBHNNNN
NHHBHNNNNBBNNNHHHHHNNHNNNHBNNBNHBBBNHNNBNHHHHHNHNNBHNHHHHNNNHHHHBHNNNNHHNNNNNNNNHNBHNBNHNNHNNNHHHNNN
HHNNNHNHNBHBNHHBHBHNNNNHNHNBNNHHHNNHNNBNBBNNBNNBNHHHHNBBNHBNBNNHHNBNBBBHNNBNNNNNHNNNNNHNNNHNHNBHNBBN
NNBHHNHHHBNHNHNNBNHNHHNNHNHHBBNHHNNBBNNNHBNNNNNNNHHBHNHBNBNNNNHNNNHBNNNHNNBNBHNHNHBHHBHBHBBNBNBBBNNN
NHBNNNNNHNNNNHHNBNHNNNNHHNHNNNNBHNBBBNNHNBHNHBHNBNNBNNHBHHHHHHBNHHNHNHHBNNNHHHNNBNNNBBBNHBHHHNHNHHHN
HBNNHHHNNNHNNBHHHHNHNHHBHNHNNNNHBNHNNHNNNNNNHHBBNBNNBBNBBNNNBBHBBNHHHNBBNNNNNHHHNHNNHNNHNHNBHBHNHHHN
HHNNNNHBBNNNHNHNNNNHHHBBBHNHBNHNBHNNNNBHNNBNNNNNNNHNBNBHHNHHNBHHNHNNNNHNBNNHHHNNBNHHHBBNBBBHNHNHBBNH
NHBNNHNNNHHNHNNBNNNNBNHHNBBHHNBNHNBBHHNBNNHNNNNNHNNNHNNNNBNNNHNNNNNNNHBHBNNNNNBNHNHHNHHBHNHHNBHHNBNH
NNNHBHNHBHHHHHBNNNNBBBHNNBHHNNHNBNBNNHHHNHNBBHNHHHBNNBNNNHHNNHNNBBBNHBHNHNBNNNNNHHNHNBHNNNNHNNNBNNNB
HBHNBHBNHNHHNNNBNNNNBNBNNHNHHNHHNBNNNNBNHNHNNHNNBHBHBHBBHNHBNHNNNNBHBNHNHNHNNNNNHNNNNBHBNBHNNNBNBNNN
NBNNNNNNHNNNBHNNBHNNBNHHNNNHNNNBNNBNNBBNNHHBHNBBBNBBNNHNNHHHBNNBHNNHNHNNHHNNNNNHHNNNHNNHNNHBHNNBBNNH
NNBNBHNNNBHBHHNNNNHBBHNNHNNNHNBBNNNNBBBHNBNNHNBNHBNHHNHNBNNNNNHBNBBHHHNNNHHBNNNNHBNBNNNNNBHHHNHHBNNH
HBHHNNHNNHNHNHHBNNBBNNNHBHHNHNBBNHNNNNHHHHBHNHNNHBHBHNHNHNHNHHHNHBNBNNNNHHBNBBNHHHHHHNBHNNHBNNHBNNNH
BHNBBBBHBNHNNBHBBNHNBNNBNNNNBHBBNHNHBNNBHHBBHNHNBBBBNNNNNBHHNNNBBNBHNNNNHNBHNNBHNHBNHNHNHNNNNNHHNNNN
HNHBBNHBHNHBBBHNHHNHBBBBHHHNNNNBNNNNNNHNHNBBHNHNHNBNBBBNNHHNNNNHNNHHNNHHNNBHNBNNHHBNNBNNBBNNBHNNHBBN
NNBBBBNHNNNNNBBNBHNHHBHNNHNNNNHNHBBNNBNNNHBBHNNHHNHBNBNBBNHNHHBBNNHHNNBNNHBNNNBBHNHHNBNBNHHNHBHNNBNH
NHNHNNBHNHNNNNHNHBHHBNHNNBNNBHNHHHNNNHNNBHNNNNHBNNHNBNBHNNBNHHHNNBNHNBHNHNBNNNNHNBHHBNNHHBNHNNNNNNNH
BNBNNNNHNNNNBHNNNHHHNNNNNNHNBBBNNHNNNNHNNNBHHBHBNNNNHHBBNHNHBNBHHNHNHNBNHNHNHHNNHBHHNNNHNNHBNHNNNNNB
HHHBNNNNHBNHNHNNHNBBHNHHNNNNBBBNHHBNHBHHNNNNNHBHHNNNBNNHHHHBNHBBNHHNNNNBNNBNBHNNNNHNNHHNNNBNNBNNNHNH
BHNHBNBNHHHHHHNHHNHNHNHHNBHHBHHNNNNNNBBBBNNHNNNNNNNNNHHNNBBHNNHHHHBNNBHHHBNBHNNHHHNNBNNBNNHHNNHNBHNN
HNNHBNNNHNHNBNNNNNNBHNNHNNBNHNBHNHNHHHNNNBBBNNNNNHNHHHHNBNNNNNNNHNNHNHNBNBNHHBNNHNNHNNBBNHHHBHHBHNHB
NNNHHBNBNNHBNHNNHBNNHNNHNNBBHNBHNBBBHHNHHNNNNNNHNNNHBNHNHNHHBNBNNBBNNHHBHNNNHNHNHBHHBBNNBHHHBHNNNBNB
NNNNNNHNBHNBBNNNBNNBHBNNNHNNNHBNNNNHHNNNNNHNNNNNNNNHHHNNNHBHNBHBNHNHHHBBHBBNHBNBNNNNHBHNNNHHNNBNNNNB
HBBNHNHNHNNNNNNBHNBBNNBNNNNBNNNHHBNHBHNNBNHNHNBBNNNNHNHHBNNNHHNHNNBHNHBNHNNNBNNHNHHNHBNBBNNNNNBBNNNN
