HNHHBBHBHHHHBHHHHHBNNNNBNBNNHHBNNHHNNNNHNBHNNNBBNHHNNBBHHHNNNNHNNNNNNNHNNHNNNBBHNHHNNNHNNBNNNNHHHNBN
NHHHNBBHHNNNNHHNNHHNHNBHNNHNNNNHNNNNHNBNNNHHHBHNNHHHNNNNBNBHNNNNHHNHNNNNHBNHHNNHHHNNBBHNHNNHNHBNNBHN
HHNNHNHBHHNNNHBNNHHNNHNBHBHNNNHBHNBNBNNNNNBNNBNHNNNNNNNHHHHNNHNBHNNBBNNNNNNNBHBBNNNHHBHHNNBNHNNNBNHH
NBHHHHNHNBNBHNHNBHNNNHHNHNNNHNNNNNNHNNNHBHNNHNHNHBHBBNNHHBNHNNNNNNBNNNNHHNNBNNBBNBBBNNHNBNBNNHHNNHHN
NHBHBHHNNNNHBNNNHHNNBNBBHNBBBNNNNBBNNBBNHNBNNNNBNHNNNHNNNNNHHHBHHNNNBNNNBNNBNBHNBBNNNHHHHHNHBNHNNBBH
NHNNBNNNNNHHNNNNNBNNNHNHBHNHHNNBNHHHHHBNHBNNHNBNBNNNHBNBBNHNBBNNHNNNNNNNHHBHNBNHNHNNNNHNHNNNNNHNBNHN
BHBBNHBNNNHNNHHBNBBNNNHNNHNNHNNHBHBNNNNNBNNBNBHNHHNBNNBNNNHNHNNNNNBNHNNHNHHBNNBNNNNNNBHHBHNHNNHNNNNH
BNBHHNHNNNNBNNBHHNNNNHNHNHNNNNNNHBNNBNNNNBNNNBNBNBNHBBNNHBHNNBNNNNNNNNHBHHHHHBNNNBNHHBHHNHBNNNBNNNNN
NNNBHNNHBHHNNNNHBHNHHHHBNHBNNNHHNHHNNNBHNHNNNNNBNHNHNNNNNBNBBNBHNHNBNNHHNBNNNNHNHNNBBNHHNBNNNHNBNBBB
BNHBNBNBHNNHHNNBHBHNHNNNNBBBHNHBHHNHNNBNHBBBHHHNHBBNHBNNHNNNHNHHNBNBBBNBNNNBNHHHHHNNHNNHHNNHNNBNNHBH
NNHNBNHHNNHHNHHBBHBHNNHNNNHNBNHHNNNHBNBNNNNNNHNHHNBHHBNHNBNHNNNNNNHBNNNHNHHNHNHBHHBNHNBNHNBNHBNNNNHN
NHHNNNNBNNNNBNNBNBNNNBNNBNHBNNNBHNNHNBNNBNBHNNBHNNNNNNHNNHNBHNNBNHHHNHNHNNNBHBNBHNNHHNBBHHNHHNNBNBNB
NHNNNBBHNHNBHNNNBBHBBNNHHHNNNBNHNNNNBBBNNBBNNNHNBNBNBHNNHBNHNHNHNHHBNNNNHBNBNHNNNNNNNBNNHBNNHBHHHBNN
HHNNNNNNBHHNNNNNNHNHNBNNNNNNNHBNNNNBNHHNNBNBHNNHNHNNBHBNNHHHNNBBNNNNHHNHBNNBBNBNHNHNBNNHNHNNNBNHNNHH
NBNNNBBNHNHNNHHNHNHNBHNHNNNHBNBNHNNBHNNHNNNNNNBHBNHBNHHNNHHNNNNNNNBNNNHHHNHNNHNNNNHNNHBNHNBHNNHNNNBB
HNNBNNHNNHNNHNNHBHBNBNNHHHHNNNHHHHHHHNNNHHNBNNNNHBBNBNNNBNNBNNHNHBNNBNBBNHBHHNNBNHBNNHBBNNNNNNNNNNNH
NHBHNNBHHHNNBHHBBNHHHHNNHNNNHBHHNBNNNNNNHHHBHNNNNNHNHBBBBNNBHBNNNNHNNHHNNHBNHNBNNNNBHBHNBBBBNBNNNNNH
HNNNHNNHNNHHNNHNNHBHHBHNNHBHBBNHHNHNBBNNNNNNHNBNNNNHBHNHHHNNNHBBHBHNHNNBHNNNHNNNNNNNNHNBNHNHNNNNBHBH
HHHNBNBNNBNNNNNBNBNNNBHNHHNHBHHNNBNHNHNHBHNNHHBNBNHNNHBHHNBNBBNNNBHBHNNNNNNNHNNNNNNBBBHHNBNNNNNHNNNN
HBBBHHHNHNNHNHNBNNHHNNHNHNBHHBNHNNNBBBBNNBNNNHBBHHBNNHNHNBNNBBHBHNBNNBHBNNHNBHHNNNNHHNBHNBNBHHBNNNBB
NBHBNNNNNHNNHNHHHBNNNHHBBNBBHNBHBNNHNBHNBBNNHHNHBNBNNBHNNNNNHBNNNNBBNNHNBHBNNBNHNBBHHNNNNHHNNNNBBBNH
HNBHNHNHHHHNHHNBNHNHNHBNNNNBNNHHNNBHNNHBNNNHHHBNHNBNNNNBBNBNNHNHHNNHBHNBNNHBBNNHHBNNNNNBHHNNNHHBBBNB
BNHHBHHNHNNNNNBNNNBBBHNNBHNNNHHHHNNNNHNBNNNNNNBHNNBNNBHNNHBHNNHNNNNHNBHNNHHNBHNHNNNHNHHHNHNNNHNBNNHB
HHNNHNHHBBNNNBNBBHNNNNNHHNBHHNHBNBNNNHHNBHNHHNNNNNNBNHNNNNHHHBHHBNBNHHHHHBBHNBHNBHNNNBNHNNNHNHNHBNBH
HHBNNNHHHHHBNHBBBHHHHNHHNNNNNNNNNNNNNBNNNNNNNNNNBNNHNNNBBNNBBHNNNNHHBHNNNNHNHBHNNHHBNNBNBNHBNNBNNNHB
NHNNHHNBNNBHNNNHNBHHNHBNHHBBNHBNNNNNNNHNNNNNNHNNHNNHBNNHNNHBBHNNBBHNNBBNBHBHNNNHNNHNNHNHNHHHNNNHNNNN
HHHNBNHHHNNNHHNHNNNNNBHNBBBNNHBHNHNNNNNNNNNBHNHHHNBHBHHNNHNNHHNNNNNHBHHNNHHNHNHNNBHBHNNNNNHHNNNNNNHB
NNNNNNHNNBNBNHBHNNNHNNNHNHHHHNNNNNHNHNBNBNNNHNNNNHNNHHNHBNHBBNHNNHNBNNNBNNNNHNNNNNBHBNHNHHHNNHBHNNNN
NHNNHNNHBHNHBBBBBNNNNBHHHHBNHNNHNHNNNNHHHBHBNHNHNHBHNBHBNHHNNHBHNHNNBNHNBHHNHBHNNNNNHNBNNNNHNNNHNHHB
HNNHBNHNHNNBNHNBHNNHNBNNHNBNBBHBBBNNHBHHBNNNNHNBNHBNHNHNNHNHHHNNHBNNNHNNNHHNBBNHNBHNHBNNNBBHNBNNHNHB
HNNBNNHHBNNNBBHNBHNNHHHBNNHNNHBNNBNNHNNNNHNBHBNNHHNHNNNNNHHBNHHNNHNNNHNHHNHHHBNNNBNBNBNBNNHNHBBNNNHN
BNHHHHNHBNNNNNHNHHBNHNNNHBBHNHHBHHBNNNBBNNHNNNNNHNNNHNNBHHBNNHHNBNHHNNHBBNNNBHBBNHHNNHBHHNHNHNBNHHBN
HBBHNNNNBBNNHNBNHBNNBBNNBBHNBHHHBNNNNHNHHBHNBBBBNHNHBBHHHNNHHNBNHNNNBHNBNNHNHHHNNBHHHBBNNNNNHNNBHHNH
HHNHNNBHNHBBHBNBBHBBNBHHNHNHNNHNHNNNNNNNNNHNBNHNNHNNNNBNBHHBHBHNNBBNBNBNHNBBBHNNNNHHHNNNBBNNNHHBNNNN
NNNNNBHNBNNHNHHNBNHHBBBNHNHNHBBHBNHNNHNBNNNNNNHNBHHNHNHHNBNNHNBHBHNNNBBNNNNNNBNNHNBNHHNNBHBHNHNNNHNN
NHNNBNHBNNNHNNNHNHHHHHNNNHNNHHHNNHHNNNHNHHNNHNNBNNNNHNHHBNNHNBBHNNHBHNHBHHNNHNNNNHHNNBHNHHHHNHNNHHHN
HNHNNHHNHHHNNHHNHBHHNHNNHNHHHBNNHHHBNNNNNHHNNHHNNNBNNNNNNNBNHHBNHHBNBNNNNHNBHNNNNHHBNHNNNHHNNBHBNNHH
NHHHNNHNHBHBNNBNNHNHNHNNNNNHHHHBNNNNHBHNBHNNNBNNNNHNBNHNBNHHNNHNNNNBNHNNHBHHHHHBHNBHHBHHHNNHHNNNHHNH
BBHNNNHHHNBNHNBNBNNNNNNHNNNNNNHNHHNNNNNNHNHHBHNNNBBHBNNBHHNHHNBNHHNNNHNHHBNNNNNBHNNBHNNNNNBNNNNNBHHB
BHNNHNNBNNBHBNNNNNNNHNNNNNNNBHNNNNNNNHHNNHNNNHNNHNNNHHNHHBNNBNHHBNHHNNNHHBHBNHNBNNNHHNHNHBNBBNHNNHHB
NHBNNNHBHNBNHNBHHNHBBNNNHBHHBNNNNNNHHHHNBBHBBHNNNNHBNHHNNNHNBNBHHHHBNNNHBHNNNHHNNNHHHNBHNHNNNNNNNNBN
NHNNBHNNNBHHBBNBHNNHHNHHHNBNNHNHBHNBHBBNNNBNNNNNNBNNNHHNBHHNNBHNNNNNNNNNNNNNHNNHBNNHHHNHBHHHNNNBHHNB
HNHNHNNNBBNHBNBHBNNNNNHNNHNNNNHNNBHBNNHNBNBNBNBHNNHBHHNNNHBBHNNHNNHHNHBBHNNHNBNBHHHBBHNNBNBBBBNNNBNB
NNNNNNNNHNBBNHNNHNNBNNBHHNNBBNHHBHBNNNNHHHNBNNNNNNBHNNBNBHNHBNNHNHNBNBNHNNBNHNNHHBNHNNBNNNNHHNNNHHNH
NNHHHBHNHBBBNNHNNHNNNHHHNHNHHBNHNHHHHNHNNNNNBBBNNHNBHHNHHNNHHBNHNNNNHNHNBNHBNNNNBBBHNNHBHBHBBNBHBBNH
NBNHNHNNHNBNHNNBNNBNBHNNNHNNHNBNNBBHHNHHHHNHHNNNNHNHNNHHHHNHHHBNNNHBNBBNNBNHBHNNHNBHHNNHHBNHNNNHNNBH
HBBNNNHHBHNNBNBNNHHHHHNHNHNHNNNNNBNHNHNBHHNNNNNBBHBNBHHHBNNHHHNNNBNHHNNNBNBHNNNBNNBHNHBNHHHHNNNNHHNH
NHNNHHBNHNHHNHBBHBBHNNBBHNNBNHNBBBBNBHBNNNHNBNHNHNHHBHHNNNNNNNNNNHNHHHNHHNNHNBHHHNBHBNBNHHNHHNHBBNHH
NNNBNBBHNNNNNNNNHHHNHNHHNBHHNNNNHNNHNBBNNBNHNNHHBHNBBHBNNNNNNNHNBNBNNNNHNNHBNNNHNNBNHHHHNNNNNNHNBHNH
NNHNHNHNNNHBNBHHBHHNNNNBNNNNHNNHBNHHHHNHHHHHNBNBNHHNHBHHNHHNNHBNNNNNHNHNBNHNBNNNHNHBHHNHNHNBNNHHNNHH
