HNNBBHHBNHBNBNHNNNBNNNNNNHNHNBNHBNNBHNBNBNHNHNHNNHNNHNNHNNNBNNNNHBNNNNNHHHHBNBNNBNNNBHBNHBHHNBBHNBHB
HHNNBHBNNBNHBNBHHBNHNNNNHHNNNBNBNHNHBNNNBHNHNHHHHNHNHBNBNBHNNHHNNNNNHNNBBBNHBNNHNHNBHNHBBHNNNNNBNHBH
NNNNHBNBNHNNBNNNNNHBBHNHHHHBHBNNBNNBHNNBNHBHNNNHHNNBNHNBNBNHNHNNNNHHBNNBNNNNNHNNHBNHBNNHHNBNNNBHNNNH
BNNNHNNBNHNBHHHNNBNHHHBNHHHBNNHNHHBHNHNNNHHNBNBNBBBHNNNHBNHHNNNBHNHBNBNNNHBHBNNHHHNBNBNHNNNNNHBNNNHB
HNHNNHNBHNNHNNNBHNNNNHHNNNNHHNBNBHNHNHNNHNHBNNNHNBNNNNNBNNNNNHNBNNNNHNNHNBBNBHNHNBHHBBNNHHBBHNNHHBHB
HBNNHNNBNNHNBHNNHNNBNNBNNNHNHHHBHNHHBHNNNNBNNNNBHNHNBNHHNNNBHNNNHHHHNNBNHNNNHHNHBHBNHBHNHNBNNHNBNNHH
HHBNNNBHHNNNNHNNHNHHBHHHNNHHHBHNNNNBNNBNNHNHNHBNHHNHNNBNBBBNNHNNBNNNBHHHBNNNNHNHBBHHNHBNNNNNBHBHNNHN
NNNBHHBBNNHHHNHBHNBNHBHBHBNHNHNNHNNHBNHNNNNNHHHBBNBHHNBNHNNNNBNNNHHNHBNNHHNBBNHNBNHNNHBNNHNHBNHNBBHH
HHHNNNNNNBHBNNNNHNNNNNBBNNNNHBBNHBBHHBNHNHNNHBBHNHHBNNBNNNBNNNNNNHHNNNNBNHNNHNNHBHHNHNHHHNNNNNNHHNHN
HNHBNBNNBNNHBNBNNBHBNNNNBHNNNBNNNHNHBHHHHHNNNHNNNBNNNHNNNNBNHBNNBBBHHNHNNNBNNBNHHNNNHBHNBHNNHHBHNBHH
BNNBNHNNHNNNNNNNNNHHNNNNNNNHHNHNHBNNHHNBHHHHNBNHHBNHBNBHHHHBNHNNNBNNHNNBHNHHNBNNNHHNNNNHNHNHNNBHHNBN
NHBHNHBNHNNNNNNNNNBNNHBHNNNBNBBNNHHHNBBNBBNNNBBHNNBHNNNNNNBBNHHBNHHNNHHNHHNNNNBNHNNNHHBHHBNNNHHBBNHB
NNNNBNHHNBNNNNNBNHNNNHNHBHHNBHNHHHBNBNHHHNBNNNNNNNNNBHBNNNNNBNHNNBNNBHNNHNHBNBHBBHHBNHNHHBNNHHBBBNBH
BNNNHHNNNHNHHNHNBBBNNHNNNHHHNBNBHBBNNHNNNNNBHNNNBHHNBBHNHHBNHNBBHNNNNNNNBNBBBBHBNHBHBBNNBNBBNNBHHNHH
NBBNBNHNNNNHHNHBHNHNNNNHHNHHBHHHNBNBBNHNNNBHNHNHNHNNNNBBHBBNNNNHHNNBNHBHNNHNHHNNBBNHNBBNHHHBBHNNNHNH
HNHHBHBNBHHNNHNHNNBNBBHBBNHNHHHNNBNNHHNHNHNNNNNBNHNNBNHNHHHBNNNHNNHNNNHNHHHNNHHHHNBBNBNNHNNNHHHHHHBH
BNHHNNHNHNNHNHNHNNBBNHNNHNBBBHBHNHBBNHHNHHNNHHNNHNNNHHHBNBNHNHNNHHNBNNBNBNBNNNHNHHBNNNNNNBNBBHHNNNNB
NBBBNBNNNBNNNNHHNHNHNHHNBNNBNNBNHNNNBBHNNNNHNNNNNBNNNNHHNNHNNNHNBHNNNNNNHHNBBNBBHNNNHHNNHHNHNNNBBNBN
NNHBNNHNNNHNNBHHHHHNNHHNHHNNHNBHHNHHHNNBNNBNHHBNHNNBHNHNNNNNHHHBHNHNNNNBNBNNHBNHBNNHBNHHNBNNHBBHNHBH
NHNNHNNBHNNBHBNBBNNHNNHNBHHNNNBHNBHNNNNNHHHNNNNHHHNBNBBHBBHNHNBNNNNNHNHHHHNNNBNNBNHNNBHHNHBHBNNNNNBH
NBHBHBBNNNNHNNBHHHHHBNHNNNNNHHNHBHNHHNHNNNBNNHNNBHBBNHNHNNNHNHBBHHNHNNHBNNNBNBHNNNHBNHHHHNNBNNBHNNNB
HBHNHNNBNNBBBNHNHNHNBBHNBNHHNHNNNNBBNNBHBNBNBNHNNHNNNBNNBBNHNNNNNHNHNNHHNBNBHNNNNNHNNNBNHBNBHBNNNHNB
HBBNNNNHHNNBNNHHNHBNHHNHNNBBNHHBNHNBBHNNNNNBBNHNNHHHBNNHBNNHHNHBHHNHNHBHHHBNNNHNNNNHNHNHNNBNNHNNNHNH
HNNHHHNNNNHBHBNNHNBNBNNNHNNBNNHBNBBNBBNHBNHNBBNNHNNBNBHNBBHHBHBNNNNNHNNHHHNHNNNBBHBBNBNNBNBNNNNNNBHN
BNHNNHHNNNNNHNBBBNHNHNHHNNHHNNBNBHNHNNNHNNHHNBNBNHHHBNNNNBNHHNNHHBBNHNNHHNHBBHNHNNNHHBNHHNNNNNHHHHHB
NNBNHNHBHBBHHHNNBHHBBBNBNNNHNHBNNHBHNBNNBBHBNHBHNHNBHHNNBBNHBNNHNNNNNNNNBNNNNNBHHNHBNNBHNNNNBNBHHNNB
NHNHHNBHNNHHHNHBNHNHHBNBNNNNHNNHNNHBNNHHHNHNHNBBHHNNNNNNNBNHHHNBNBBHNHNNNHBNHNNHBNNHHBHHNBHHHNHNHBBH
HHNNNNNHNNNBNBNBBHHNNNHBHHHNBBNHBNNBNNNHHNNHNBNHBHHHHBHNNBNNNNNHBNHHHHHBNNHHNNNNBNHHNNHNHHNBNHBBNNNB
BNNNHNNHNNBHNNBBBBNNNHNHBHNHHBHNBHNNNHNHNNHNNBNNBNNHNHNBBNBBNHNHBHHBNNNHNNNNBBHNNHNHNBNNNNNNHHHBNHBN
NNHNHNHHHHBHNHNHHNNHNHNBBHHBNNNNNBNNHNNNNHHNNNNNNHHHNNNNNNBBBHBHNHNNNHHHNBNHNHHNHBNHBBNBHNNNNHNNHNNN
NNBHNHNHNNHNNHNHNNBNNNNNNHNNHNHHBBHHNHBNNNHHHBNNBHNHHNNNHNNHNNHHNHHNHNHNNNHHHHNNHBBNNHHHBNNHNNNHNHNN
HBNNHNBNBBBNNNNHNNNHNNNHHNNNHNBNNHNNNHNHNNNHBHNNNHNNHBHNHNHBHNNHHNHHBNNHNHNBNNHNHNNNNBHNBNNBHNNHHHHN
HHNHHNHNNBNHNBHNHHNNBBHNNHNHNNHNHNNNHNHBBBHBNHNNBNNBBHNBBHBNHHHHNBHHNHNNHBHNHBBHBBHNBBNHHBHNBHNNBNNN
BHHHHNNHHNNNNNHHNNNHHNBNNNNNHNNHNNNBHNHNHNBHBBHBBHNNNNNBHNNHNHNNHHNNHHHNHNBNNBBHHBHBNHNHNNNBNNHBBHNN
HHNHNHNNNNNNBHNNBNNBHBBNNHNHNHNHBBNHBBNNNHBHNHNNHHNBNNNNBNHHNNBHNNNNNHHHNHNNNHHNNHNBHNBNBHHHNNHHBHHN
HBBNNNHNNBHNHNNHHHHHHBBHHNNHNNBNNNBHBBHNBHNBNHNHHNNNHHNHNBBNBBNNHNNNNNNNHNHNBNHNBBNBHNBNBHHHNNNBHNBB
NNHHHNNNBHBNBBNHNNNNBHNBNHHBBHBHBNHHHNBNHBNHHNNHBHHBNNNHNNNBNNNNBNHNNNNHNNNBNNNHHBHHNBHNBHHHHNNBHNNN
HHNHNHNHNNNHHNHBHNNNHNNHNHHNBNHBNBNBHHNHHBNNBNNNNNNBNNBHHNHNNBHNHBHNNBHNNNBNNNHNHNNNHHNHHHNHNNNNBBHB
BNHBHNHHHHHNNBBHNNNHHNBHNBHNHHNNNHNBNBHNHBNHHNNHBNBHBNHBHHNBNHNNNHHNNBHBNHHHHHNNNNHNBHNHBNBHHNNBNNNH
HNHNNHNNHHHNHHNHNNHNHHNHBNHBNHNBBNHNHBBNNHHNNNBNNNHNNNNBNNHHNHNBBNNNBHHNNNNHNNNHBHHNBNNNNBNNNNNHNHNH
NBNBNBNHHHNNNNNBNHNBNNHNNNNHBBNHHNNNBHNNNNNNHNNBNHNNHNHBNNBBHNNNHHHNBHNBNNBHNNHNHNBHNHNNHNBHNHBBHBHB
NNBHNNNHHHNHNHBNNHNNNNBHHHBNHNNNNHHBNNNNBNHNNHHNBNHHNNNHNNBHNNBNHHHBBNHNHNNNBHNNHNHBBNHNNHBNHHHBNNNN
NHNBHNHNNNHNHNNNHNNNNNNNBNHNNNNHBBNNBBNBHNBNHHNHHNBHHNNNBBNNNNHNHNNNBNNHNHHHBNNNBBHNBNNBNBNBHNHNNHBH
HBNNNHNNNNHNNNHNBHNNNNNNNBBHHNHNNHHNBBBHNNBBNNNHNNBNBBNBHNNNNBBBNNHNNBBNHNBHNBBNNNHBNNNHHBNHNBHHHNNB
HBNHHNNBNHNNNHBBNNHHNBNNHNBBBNHNNHHHNNNNHBBHNNNNHHHHHBHBNBBNHNNHHBNHNBBNNHBBBNHHHNBNHNHBNNNHNNNNNHNN
HBBHNBNHBNBHBHNNBHHHBHHNBNNNNNBHNHNNNNNHBHHHHNNNNNNHNHNNNNBNNNHBNNHNNNHNNNNBNHBNHNHNHHNNHBNNNBBBHBHH
NBHHNNHNNNBNNNNBNHNNNHBBBBHNHNHHHNHBHNNBNNNNNHBHNNHNHNHBBHNBHBBHNBNNNHHNNNHHHBHNHHNHBBBHNNNNNBNBBNHH
NHBNHNNHBNNNHNNHNHNBHBNBNBHNHNHNHNNNNNNHNHNNBHNNBNBNHHHHHNNBHBNNHBBHBHHBNNHNNBNBHNNNNBNNNNNNNHHHNBHH
NHHHHHNHHBNNNHNNNBBHBNHHBNNNBNHNHNNNNNNBNBNHHHHNNNNNHHHHNNNHNHNHHHHNNHNNHHHNNBNNNHBHHBBNNNNNNHNBNHNB
BNNNBHBNHNBBHNHHNHNNNBHHNHNNHBNNHNBHNNNNNNNNNBNHNNNHBNHNNBNHBHNBNHHNNBHNNHNNNNNBHNHNNNBHBNNHNNNNHNNB
